erbärmlich	wretched	»Erbärmlich«, kommentierte Fred den Wurf.
staubig	dusty	Sein langer grüner Umhang war staubig und verschlissen.
verschlissen	worn out	Sein langer grüner Umhang war staubig und verschlissen.
beißend	biting	»Nichts außer ein paar schrumpfenden Schlüsseln und einem beißenden Kessel«, gähnte Mr Weasley.
zuständig	appropriate	»Außerdem noch einige recht üble Sachen, für die wir allerdings nicht zuständig sind.
das Frettchen	ferret	Mortlake haben sie wegen ein paar äußerst merkwürdiger Frettchen zum Verhör mitgenommen, aber das fällt nicht in meine Abteilung, Gott sei Dank«– »Warum sollte sich jemand die Mühe machen, Türschlüssel schrumpfen zu lassen?«, fragte George.
das Verhör	interrogation	Mortlake haben sie wegen ein paar äußerst merkwürdiger Frettchen zum Verhör mitgenommen, aber das fällt nicht in meine Abteilung, Gott sei Dank«– »Warum sollte sich jemand die Mühe machen, Türschlüssel schrumpfen zu lassen?«, fragte George.
schrumpfen	shrink	Mortlake haben sie wegen ein paar äußerst merkwürdiger Frettchen zum Verhör mitgenommen, aber das fällt nicht in meine Abteilung, Gott sei Dank«– »Warum sollte sich jemand die Mühe machen, Türschlüssel schrumpfen zu lassen?«, fragte George.
übrig	left	»Verkaufen ihnen Schlüssel, die zusammenschrumpfen, bis nichts mehr übrig ist, und die Muggel können sie dann nicht mehr finden« Natürlich ist es sehr schwer jemanden dafür ranzukriegen, denn kein Muggel würde zugeben, daß sein Schlüssel schrumpft – sie behaupten andauernd, sie würden sie verlieren.
das Gesetz	law	»Nun, Liebling, ich denke, du wirst feststellen, daß er sich damit durchaus im Rahmen des Gesetzes bewegt, selbst wenn, ähm, er vielleicht besser daran getan hätte, seiner, ähm, Frau die Wahrheit zu sagen« es gibt da eine Lücke im Gesetz, wie du sehen wirst« solange er nämlich nicht beabsichtigte, den Wagen zu fliegen, ist die Tatsache, daß der Wagen fliegen könnte, nicht unbedingt «– »Arthur Weasley, du selbst hast dafür gesorgt, daß es eine Lücke gibt, als du dieses Gesetz verfaßt hast«, rief Mrs Weasley, »damit du weiter an diesem ganzen Muggels
beabsichtigen	(to) intent	»Nun, Liebling, ich denke, du wirst feststellen, daß er sich damit durchaus im Rahmen des Gesetzes bewegt, selbst wenn, ähm, er vielleicht besser daran getan hätte, seiner, ähm, Frau die Wahrheit zu sagen« es gibt da eine Lücke im Gesetz, wie du sehen wirst« solange er nämlich nicht beabsichtigte, den Wagen zu fliegen, ist die Tatsache, daß der Wagen fliegen könnte, nicht unbedingt «– »Arthur Weasley, du selbst hast dafür gesorgt, daß es eine Lücke gibt, als du dieses Gesetz verfaßt hast«, rief Mrs Weasley, »damit du weiter an diesem ganzen Muggelschrott in deinem Schuppen herumbasteln kannst!
die Lücke	gap	»Nun, Liebling, ich denke, du wirst feststellen, daß er sich damit durchaus im Rahmen des Gesetzes bewegt, selbst wenn, ähm, er vielleicht besser daran getan hätte, seiner, ähm, Frau die Wahrheit zu sagen« es gibt da eine Lücke im Gesetz, wie du sehen wirst« solange er nämlich nicht beabsichtigte, den Wagen zu fliegen, ist die Tatsache, daß der Wagen fliegen könnte, nicht unbedingt «– »Arthur Weasley, du selbst hast dafür gesorgt, daß es eine Lücke gibt, als du dieses Gesetz verfaßt hast«, rief Mrs Weasley, »damit du weiter an diesem ganzen Muggelschrott in deinem Schuppen herumbasteln kannst!
der Schuppen	shelter	selbst wenn, ähm, er vielleicht besser daran getan hätte, seiner, ähm, Frau die Wahrheit zu sagen« es gibt da eine Lücke im Gesetz, wie du sehen wirst« solange er nämlich nicht beabsichtigte, den Wagen zu fliegen, ist die Tatsache, daß der Wagen fliegen könnte, nicht unbedingt «– »Arthur Weasley, du selbst hast dafür gesorgt, daß es eine Lücke gibt, als du dieses Gesetz verfaßt hast«, rief Mrs Weasley, »damit du weiter an diesem ganzen Muggelschrott in deinem Schuppen herumbasteln kannst!
schief	leaning	Sie schlichen sich aus der Küche und gingen einen engen Gang entlang zu einer schiefen Treppe, die sich zickzackförmig durch das Haus emporwand.
plappern	chatter	»Ginny«, sagte Ron, »du weißt ja nicht, wie komisch es ist, daß sie so scheu ist, normalerweise hört sie nicht auf zu plappern «– Sie stiegen noch zwei Stockwerke hoch und standen nun vor einer Tür.
der Hochofen	blast furnace	Es war, als ob er in einen Hochofen geraten wäre: Fast alles in Rons Zimmer glühte orangerot; die Bettdecke, die Wände, sogar die Decke.
der Stoß	pile	Rons Zauberspruchbücher für die Schule waren achtlos in einer Ecke gestapelt, daneben ein Stoß Comic-Hefte, alle offenbar Abenteuer von Martin Miggs, dem mickrigen Muggel.
mickerig	measly	Rons Zauberspruchbücher für die Schule waren achtlos in einer Ecke gestapelt, daneben ein Stoß Comic-Hefte, alle offenbar Abenteuer von Martin Miggs, dem mickrigen Muggel.
die Schar	flock	Weit unten auf dem Feld konnte er eine Schar Gnomen erkennen, die durch die Hecke der Weasleys zurückschlichen.
das Urteil	opinion	Er wandte sich um und sah, daß Ron ihn etwas nervös beobachtete, als ob er auf sein Urteil wartete.
das Rohr	pipe	Und direkt unter dem Ghul in der Dachkammer, der immer auf die Rohre klopft und stöhnt«– Doch Harry grinste breit:»Das ist das beste Haus, in dem ich je war.«
prickeln	tingle	»Das klingt ja prickelnd«– »Haut ab«, fauchte ihn Percy an.
der Kramladen	junk shop	Filibusters Fabelhaftem Nass zündendem Hitzefreiem Feuerwerk»eindeckten, und in einem winzigen Kramladen voll zerbrochener Zauberstäbe, schiefer Messingwaagen und alter Umhänge mit Zaubertrankflecken stießen sie auf Percy, tief versunken in ein kleines und elend langweiliges Buch namens Vertrauensschüler und ihr Weg zur Macht.
fabelhaft	fantastic	Filibusters Fabelhaftem Nass zündendem Hitzefreiem Feuerwerk»eindeckten, und in einem winzigen Kramladen voll zerbrochener Zauberstäbe, schiefer Messingwaagen und alter Umhänge mit Zaubertrankflecken stießen sie auf Percy, tief versunken in ein kleines und elend langweiliges Buch namens Vertrauensschüler und ihr Weg zur Macht.
der Abstecher	side trip	Auch eine Liste der neuen Bücher für das folgende Schuljahr war enthalten: Schüler der zweiten Klasse benötigen: Miranda Habicht: Lehrbuch der Zaubersprüche, Band 2 Gilderoy Lockhart: Tanz mit einer Todesfee Gilderoy Lockhart: Gammeln mit Gulen Gilderoy Lockhart: Ferien mit Vetteln Gilderoy Lockhart: Trips mit Trollen Gilderoy Lockhart: Abstecher mit Vampiren Gilderoy Lockhart: Wanderungen mit Werwölfen Gilderoy Lockhart: Ein Jahr bei einem Yeti Fred hatte seine Liste durchgesehen und spähte hinüber auf Harrys Blatt.
feilschen	haggle	»Ich bin etwas in Eile, Borgin, muß heute noch wichtige Geschäfte erledigen «– Sie begannen zu feilschen.
die Beleidigung	insult	»Ich hoffe, aus meinem Sohn wird mehr als ein Dieb oder Plünderer, Borgin«, sagte Malfoy kühl, und Mr Borgin setzte rasch nach: »Das sollte keine Beleidigung sein, Sir, keinesfalls «– »Sollten allerdings seine Schulnoten nicht besser werden«, sagte Mr Malfoy noch kühler, »könnte es durchaus sein, daß er so endet «– »Das ist nicht meine Schuld«, erwiderte Draco.
das Gift	poison	Es gibt Gerüchte über ein neues Muggelschutzgesetz – kein Zweifel, daß dieser flohgebissene Muggelfreund Arthur Weasley dahinter steckt «– Harry spürte, wie Zorn in ihm hochkochte. »- und wie Sie sehen, könnten einige dieser Gifte den Eindruck erwecken «– Verstehe vollkommen, Sir, natürlich«, sagte Mr Borgin.
der Ruhm	fame	»Ah, die Hand des Ruhmes!«, sagte Mr Borgin, ließ Mr Malfoys Liste liegen und schlurfte hinüber zu Draco.
schnurz	all the same	»Denen wäre das schnurz«, versicherte ihr Harry, »Dudley würde es für einen irren Witz halten, wenn ich irgendwo in einem Kamin verloren ginge, machen Sie sich darüber keine Gedanken «– »Nun denn« bist du bereit?«
barsch	short	»Wenn das so ist, können wir vielleicht auf die Liste zurückkommen«, sagte Mr Malfoy barsch.
kahl	bald	»Harry«, keuchte Mr Weasley, »wir haben gehofft, daß du nur einen Kamin zu weit geflogen bist«–Er rieb seine kahle glänzende Stelle am Kopf, »Molly ist ganz außer sich – sie kommt gleich «– »Wo bist du rausgekommen?«, fragte Ron.
stürzen	fall	»Mit solchen Leuten geben Sie sich ab, Weasley, und ich hatte gedacht, Ihre Familie könnte nicht noch tiefer sinken «– Es gab ein metallisches Klingen, als Ginnys Kessel durch die Luft flog; Mr Weasley hatte sich auf Mr Malfoy gestürzt und ihn mit dem Rücken gegen ein Bücherregal geworfen; Dutzende dickleibige Zauberbücher klatschten auf ihre Köpfe;»Pack ihn, Dad«, rief Fred oder George; Mrs Weasley kreischte»Nein, Arthur, nein«; die Menge wich blitzschnell zurück und warf noch mehr Regale um;»Meine Herren, bitte – bitte!«, rief der Verkäufer, und dann, lauter als alle andern -»Aufhören damit, meine Herren, aufhören «– Durch das Meer von Büchern watete Hagrid auf sie zu.
die Stelle	place	»Harry«, keuchte Mr Weasley, »wir haben gehofft, daß du nur einen Kamin zu weit geflogen bist«–Er rieb seine kahle glänzende Stelle am Kopf, »Molly ist ganz außer sich – sie kommt gleich «– »Wo bist du rausgekommen?«, fragte Ron.
schmollend	sulkily	»Was nützt das, wenn ich nicht in der Hausmannschaft bin?«, sagte Malfoy schmollend und sichtlich schlecht gelaunt.
die Sondergenehmigung	special permit	Sondergenehmigung von Dumbledore, damit er für Gryffindor spielen kann.
das Gehabe	demeanor	Kaum war die Tür ins Schloß gefallen, fiel auch das schmierige Gehabe von Mr Borgin ab.
schmierig	greasy	Kaum war die Tür ins Schloß gefallen, fiel auch das schmierige Gehabe von Mr Borgin ab.
die Befriedigung	satisfaction	»Nein, er hat verkauft «– »Also macht er sich Sorgen«, sagte Mr Weasley mit grimmiger Befriedigung.
die Öffentlichkeit	publicness	»Ein gutes Beispiel für deine Kinder – sich in aller Öffentlichkeit zu prügeln – was muß bloß Gilderoy Lockhart gedacht haben «– »Er war zufrieden«, sagte Fred, »hast du ihn nicht gehört, als wir gegangen sind?
verdorben	corrupted	»Verdorben bis in den Kern, die ganze Familie, das weiß doch jeder – einem Malfoy darf man nicht zuhören – böses Blut, das ist es – kommt jetzt – laßt uns von hier verschwinden.«
zerzausen	ruffle	Er setzte sich auf den einzigen freien Stuhl, sprang jedoch gleich wieder hoch und hob einen zerzausten grauen Federwisch hoch – zumindest sah es für Harry so aus, bis er sah, daß der Federwisch atmete.
kauen	chew	»Aah, wie gern würde ich Lucius Malfoy wegen irgendwas drankriegen«– »Sei bloß vorsichtig, Arthur«, sagte Mrs Weasley mit schneidender Stimme, während die Empfangskobolde sie mit einer Verbeugung hineinwiesen, »diese Familie bedeutet Ärger, beiß nicht mehr ab, als du kauen kannst «– »Du glaubst wohl, ich könnte es mit Lucius Malfoy nicht aufnehmen?«, sagte Mr Weasley entrüstet, doch gleich darauf lenkte ihn der Anblick von Hermines Eltern ab, die vor dem Schalter standen, der die große marmorne Halle durchmaß, und darauf warteten, daß Hermine sie vorstellte.
das Versteck	hiding	Harry beobachtete nervös, wie Draco mit neugierigem Blick auf die ausgestellten Waren seinem Versteck immer näher rückte.
gemeinsam	common	»Ich muß los und sie suchen«– Gemeinsam machten sie sich auf den Weg.
reizend	annoyed	»Eine Ehre – und den jungen Mr Malfoy hat er auch mitgebracht – wie reizend.
der Federwisch	feather duster	Er setzte sich auf den einzigen freien Stuhl, sprang jedoch gleich wieder hoch und hob einen zerzausten grauen Federwisch hoch – zumindest sah es für Harry so aus, bis er sah, daß der Federwisch atmete.
begutachten	(to) examine	Er hielt inne, um einen langen Henkersstrick zu begutachten, und las mit feixender Miene das Kärtchen, das an ein herrliches Opalhalsband geheftet war: Vorsicht: Nicht berühren.
jauchzen	(to) cheer	Den Grund dafür verkündete ein großes Banner, das über die Fenster im ersten Stock gespannt war: GILDEROY LOCKHART signiert seine Autobiographie ZAUBRISCHES ICH heute von 12 Uhr 30 bis 16 Uhr 30 »Wir können ihn hier treffen!«, jauchzte Hermine, »immerhin hat er fast alle Bücher auf unserer Liste geschrieben!«
erledigt	done, finished	Er trat näher, streckte die Hand nach dem Türgriff aus - »Das wär erledigt«, sagte Mr Malfoy am Ladentisch.
gewagt	risked	Der echte Lockhart trug einen vergißmeinnichtblauen Umhang, genau passend zu seinen Augen; ein Zauberer-Spitzhut saß gewagt schräg auf seinem gewellten Haar.
schräg	diagonal	Der echte Lockhart trug einen vergißmeinnichtblauen Umhang, genau passend zu seinen Augen; ein Zauberer-Spitzhut saß gewagt schräg auf seinem gewellten Haar.
hämisch	malicious	Er richtete sich auf und blickte in das Gesicht Draco Malfoys, der sein übliches hämisches Grinsen aufgesetzt hatte.
immerhin	at any rate	Den Grund dafür verkündete ein großes Banner, das über die Fenster im ersten Stock gespannt war: GILDEROY LOCKHART signiert seine Autobiographie ZAUBRISCHES ICH heute von 12 Uhr 30 bis 16 Uhr 30 »Wir können ihn hier treffen!«, jauchzte Hermine, »immerhin hat er fast alle Bücher auf unserer Liste geschrieben!«
die Schliche (pl.)	tricks	»Faszinierend!«, sagte er dann immer, wenn Harry ihm erzählte, wie man ein Telefon benutzte, »wirklich genial, wie viele Schliche die Muggel gefunden haben, um ohne Zauberei durchzukommen.«
die Gerätschaften (pl.)	tools	Böse Masken glotzten von den Wänden herab, eine Sammlung menschlicher Knochen lag auf dem Ladentisch und rostige, spitze Gerätschaften hingen von der Decke.
die Hüfte	hip	Der Verkäufer machte Anstalten, sie aufzuhalten, doch er reichte kaum bis zu Hagrids Hüfte und schien es sich anders zu überlegen.
entzückt	delighted	»Aber Sie sind ja Muggel!«, sagte Mr Weasley entzückt.
erstrecken	(to) stretch	Sein Bankguthaben hatte er bei den Dursleys nie erwähnt; er glaubte nämlich, daß ihr Entsetzen bei allem, was mit Zauberei zu tun hatte, sich nicht auf einen großen Haufen Gold erstrecken würde.
schäbig	shabby	Aus dem Schatten eines Hauseingangs heraus verfolgten ihn die Blicke zweier schäbig aussehender Zauberer, die sich hin und wieder Worte zumurmelten.
beklommen	uneasy	Harry genoß die halsbrecherische Spritztour zum Verlies der Weasleys, doch als das Schloß geöffnet wurde, wurde ihm plötzlich ganz komisch, noch beklommener als in der Nokturngasse.
die Prise	pinch	Harry nahm die Brille ab und verstaute sie sicher in seiner Tasche, bevor er eine Prise Flohpulver nahm.
die Pferdekoppel	horse field	Harry, Ron, George und Fred wollten zu einer kleinen Pferdekoppel der Weasleys auf dem Hügel hinter dem Haus.
der Schnappschuss	snapshot	»Aus dem Weg da«, schnauzte er Ron an und trat für einen besseren Schnappschuß einen Schritt nach hinten, »ich bin vom Tagespropheten «– »Na, wenn das so ist«, sagte Ron und rieb sich den Fuß, auf den der Fotograf getreten war.
prügeln	beat	»Ein gutes Beispiel für deine Kinder – sich in aller Öffentlichkeit zu prügeln – was muß bloß Gilderoy Lockhart gedacht haben «– »Er war zufrieden«, sagte Fred, »hast du ihn nicht gehört, als wir gegangen sind?
die Werbung	advertising	Er hat den Typen vom Tagespropheten gebeten, ja die Schlägerei nicht zu vergessen – das sei die beste Werbung «– Es war ein niedergeschlagenes Grüppchen, das sich auf den Weg zum Kamin im Tropfenden Kessel machte, von wo aus Harry, die Weasleys und all ihre Einkäufe mittels Flohpulver zum Fuchsbau zurückreisten.
lahm	lame	»Errol«, sagte Ron, nahm die lahme Eule aus Percys Händen und zog einen Brief unter ihrem Flügel hervor.
der Bescheid	notice	Sag mir, sobald du kannst, Bescheid, was los ist.
das Entsetzen	horror	Sein Bankguthaben hatte er bei den Dursleys nie erwähnt; er glaubte nämlich, daß ihr Entsetzen bei allem, was mit Zauberei zu tun hatte, sich nicht auf einen großen Haufen Gold erstrecken würde.
treiben	drive	»Möchte wissen, was er eigentlich treibt«, sagte Fred stirnrunzelnd.
die Ankunft	arrival	Eines sonnigen Morgens, gut eine Woche nach Harrys Ankunft im Fuchsbau, erhielt er einen Brief aus Hogwarts.
blendend	dazzling	Seine blendend weißen Zähnen blitzten der Menge entgegen.
der Zwicker	pince-nez	»Ihnen ist natürlich zu Ohren gekommen, daß das Ministerium verstärkt Hausdurchsuchungen durchfährt«, sagte Mr Malfoy, zog eine Pergamentrolle aus der Tasche und wickelte sie für Mr Borgin auf»Ich habe ein paar – ähm – Gegenstände zu Hause, die mich in eine peinliche Lage bringen könnten, wenn die Leute vom Ministerium kämen«– Mr Borgin klemmte sich einen Zwicker auf die Nase und beugte sich über die Liste.
zögern	hesitate	Ohne Zögern trat er mitten ins Feuer, rief»Winkelgasse»und verschwand.
heil	safe	»Nun, es gibt furchtbar viele Zaubererfeuer, aus denen du wählen kannst, aber wenn du deutlich gesprochen hast «– »Er wird schon heil ankommen, Molly, mach's nicht kompliziert«, sagte Mr Weasley und nahm ebenfalls von dem Flohpulver.
klirrend	clinking	In dem Augenblick, als sie Harry sah, stieß sie ihre Haferbreischale vom Tisch, und laut klirrend landete diese auf dem Boden.
zappeln	(to) wriggle	»Und halt die Augen geschlossen«, sagte Mrs Weasley, »der Ruß «– »Zappel nicht rum«, sagte Ron, »sonst fällst du noch aus dein falschen Kamin «– »Aber gerat nicht in Panik und steig nicht zu früh aus.
der Abstand	distance, spacing	Sie flogen abwechselnd Harrys Nimbus Zweitausend, der mit Abstand der beste Besen war; Rons alter Shooting Star wurde nicht selten von vorbeifliegenden Schmetterlingen überholt.
fahl	pale	Er hatte das gleiche fahle, spitze Gesicht und die gleichen kalten grauen Augen.
tauchen	dive	Sie tauchte unter den Tisch, um die Schale aufzuheben, und als sie wieder hochkam, glühte ihr Gesicht wie die untergehende Sonne.
aufheben	pick up	Sie tauchte unter den Tisch, um die Schale aufzuheben, und als sie wieder hochkam, glühte ihr Gesicht wie die untergehende Sonne.
überholt	outdated, outmatched	Sie flogen abwechselnd Harrys Nimbus Zweitausend, der mit Abstand der beste Besen war; Rons alter Shooting Star wurde nicht selten von vorbeifliegenden Schmetterlingen überholt.
auffangen	(to) catch	Stattdessen warfen sie einander Äpfel zu, die sie auffangen mussten.
der Ruß	soot	»Und halt die Augen geschlossen«, sagte Mrs Weasley, »der Ruß «– »Zappel nicht rum«, sagte Ron, »sonst fällst du noch aus dein falschen Kamin «– »Aber gerat nicht in Panik und steig nicht zu früh aus.
in Beifall ausbrechen	applause	Das Publikum brach in Beifall aus.
besessen	obsessed	Harrys Gesicht brannte, als Lockhart ihm für den Fotografen die Hand schüttelte, der wie besessen ein Bild nach dem andern schoß und die Weasleys in dicken Rauch hüllte.
der Magen	stomach	Offenbar drehte er sich rasend schnell um sich selbst -um ihn her ein ohrenbetäubendes Tosen – er versuchte die Augen offen zu halten, doch der grüne Flammenwirbel legte sich ihm auf den Magen – etwas Hartes schlug gegen seinen Ellbogen, und er drückte ihn fest an die Seite, sich immer noch weiterdrehend – nun schienen kalte Hände gegen sein Gesicht zu klatschen »–durch die Brille blinzelnd sah er verschwommen einen Strom von Kaminen und kurz auch die Räume dahinter – in seinem Bauch rumorten die Schinkenbrote – er schloß die Augen und wünschte, es würde endlich aufhören, und dann - Mit dem Gesicht nach unten fiel er auf kalten
entgegen	towards	Eine alte Hexe stand vor ihm und hielt ihm eine Schale entgegen.
beneiden	envy	Es fiel ihm schwer, Ron nicht zu beneiden, wenn er an die Dursleys dachte und daran, wie sie ihn wohl willkommen heißen würden, wenn er das nächste Mal im Ligusterweg auftauchte.
Sonderausstattung	special equipment	Er hatte natürlich nicht mit Mr Weasleys Sonderausstattung gerechnet.
die Scheibe	disc	Als Harry, Ron, Fred, George und Percy endlich bequem auf der Rückbank Platz genommen hatten, spähte Mrs Weasley durch die Scheibe ins Wageninnere: »Die Muggel können doch mehr, als wir ihnen zutrauen, nicht wahr?
der Federkiel	quill	Schon beim ersten Hahnenschrei wachten sie auf, doch merkwürdigerweise hatten sie alle noch eine ganze Menge zu erledigen: Mrs Weasley hetzte schlecht gelaunt herum und suchte Sockenpaare und Federkiele zusammen.
zutrauen	(to) give credit	Als Harry, Ron, Fred, George und Percy endlich bequem auf der Rückbank Platz genommen hatten, spähte Mrs Weasley durch die Scheibe ins Wageninnere: »Die Muggel können doch mehr, als wir ihnen zutrauen, nicht wahr?
anhalten	(to) stop	Er hatte kaum Zeit, sich zu fragen, wann er es wieder sehen würde, als sie auch schon anhielten: George hatte seine Kiste mit Filibuster-Feuerwerk vergessen.
das Tagebuch	diary	Und sie waren kurz vor der Autobahn, als Ginny schreiend verkündete, sie habe ihr Tagebuch vergessen.
das Gemüt	nature	Als sie endlich wieder in den Wagen stieg, waren sie schon sehr spät dran und die Gemüter waren gereizt.
gereizt	irritated	Als sie endlich wieder in den Wagen stieg, waren sie schon sehr spät dran und die Gemüter waren gereizt.
das Weh	sore	Weh tat es nicht, aber sie mußten aufpassen, daß kein Muggel sie verschwinden sah.
sich vergewissern	make sure	Harry vergewisserte sich, daß Hedwigs Käfig verschlossen und der Koffer sicher festgezurrt war, und drehte seinen Gepäckwagen zur Absperrung hin.
die Absperrung	barrier	Harry vergewisserte sich, daß Hedwigs Käfig verschlossen und der Koffer sicher festgezurrt war, und drehte seinen Gepäckwagen zur Absperrung hin.
purzeln	tumble	Beide Karren knallten gegen die Absperrung und prallten zurück; mit lautem Krachen fiel Rons Koffer herunter, Harry verlor den Halt, der Käfig mit Hedwig purzelte auf den blank gewienerten Boden und empört kreischend schlitterte sie davon; die Leute um sie her starrten sie an und ein Wachmann in der Nähe rief.
die Tierquälerei	cruelty to animals	»Hatten die Karre nicht mehr im Griff«, keuchte Harry und richtete sich auf, die Hände an die Rippen gepreßt; Ron stürzte los, um Hedwig zu holen, die ein solches Theater veranstaltete, daß einige Umstehende von Tierquälerei zu munkeln begannen.
flau	slack	»Wir verpassen noch den Zug«, flüsterte Ron, »ich weiß nicht, warum das Tor sich verschlossen hat «– Harry sah mit einem flauen Gefühl in der Magengegend zu der riesigen Uhr hoch.
hölzern	wooden	Von Harry kam ein hölzernes Lachen.
die Klemme	clamp	»Wir können mit dem Wagen nach Hogwarts fliegen« »Aber ich dachte «– »Wir stecken in der Klemme, oder?
die Beschränkung	limitation	Und selbst minderjährige Zauberer dürfen in einem echten Notfall zaubern, Abschnitt neunzehn oder so des Erlasses zur Beschränkung des Weißichnichtwas«– Harrys Panik verwandelte sich jäh in Begeisterung.
knattern	rattle	Dann hörten sie ein lebhaftes Knattern und der Wagen, Harry und Ron tauchten wieder auf.
das Handschuhfach	glove compartment	Das ist die einzig wahre Art zu reisen, dachte Harry: vorbei an schneeigen Wolkenwirbeln und -türmchen, in einem von heißem, hellem Sonnenlicht durchfluteten Wagen, mit einer großen Packung Sahnebonbons im Handschuhfach und der Aussicht auf die neidischen Gesichter von Fred und George, wenn sie vor aller Augen sanft auf dem üppigen Rasen vor Schloß Hogwarts landen würden.
anmutig	graceful	London lag nun weit hinter ihnen, statt dessen sahen sie anmutige grüne Felder, die allmählich weitläufigen, purpurn schimmernden Mooren wichen, Weilern mit kleinen Spielzeugkirchen und einer großen Stadt, in der es von Autos nur so wimmelte, die an bunte Ameisen erinnerten.
der Weiler	hamlet	London lag nun weit hinter ihnen, statt dessen sahen sie anmutige grüne Felder, die allmählich weitläufigen, purpurn schimmernden Mooren wichen, Weilern mit kleinen Spielzeugkirchen und einer großen Stadt, in der es von Autos nur so wimmelte, die an bunte Ameisen erinnerten.
ereignislos	uneventful	Mehrere ereignislose Stunden später jedoch musste sich Harry eingestehen, daß er allmählich die Lust verlor.
das Steuer	steering wheel	»Na komm schon«, flehte Ron und rüttelte ein wenig am Steuer, »wir sind doch fast da, los «– Der Motor stöhnte auf.
das Sehnen	tendons	Er war durchgeknackst und fast entzweigebrochen; die Spitze hing lahm herab und wurde nur noch von ein paar Sehnen gehalten.
schmettern	(to) dash, (to) throw	In genau diesem Moment schlug etwas mit der Kraft eines rasenden Nashorns gegen seine Wagentür und schmetterte ihn gegen Ron, während zugleich ein ebenso heftiger Schlag das Dach traf.
der Ast	branch	»Was ist «– Ron starrte mit offenem Mund durch die Scheibe, und Harry folgte seinem Blick gerade noch rechtzeitig, um zu sehen, wie ein Ast, so dick wie eine Pythonschlange, auf sie einschlug.
der Hagel	hail	»Aaarh!«, sagte Ron, als ein weiterer Ast sich zurückbog und eine tiefe Delle in die Fahrertür schlug; die Windschutzscheibe zitterte nun unter einem Hagel von Schlägen knöchelartiger Zweiglein, und ein Ast, so dick wie ein Rammbock, hämmerte wild auf das Dach ein, das sich immer tiefer eindellte - »Raus hier, schnell!«, schrie Ron und warf sich mit aller Kraft gegen die Tür, doch schon schleuderte ihn ein teuflischer Aufwärtshaken in Harrys Schoß.
der Rammbock	battering ram	»Aaarh!«, sagte Ron, als ein weiterer Ast sich zurückbog und eine tiefe Delle in die Fahrertür schlug; die Windschutzscheibe zitterte nun unter einem Hagel von Schlägen knöchelartiger Zweiglein, und ein Ast, so dick wie ein Rammbock, hämmerte wild auf das Dach ein, das sich immer tiefer eindellte - »Raus hier, schnell!«, schrie Ron und warf sich mit aller Kraft gegen die Tür, doch schon schleuderte ihn ein teuflischer Aufwärtshaken in Harrys Schoß.
der Aufwärtshaken	uppercut	»Aaarh!«, sagte Ron, als ein weiterer Ast sich zurückbog und eine tiefe Delle in die Fahrertür schlug; die Windschutzscheibe zitterte nun unter einem Hagel von Schlägen knöchelartiger Zweiglein, und ein Ast, so dick wie ein Rammbock, hämmerte wild auf das Dach ein, das sich immer tiefer eindellte - »Raus hier, schnell!«, schrie Ron und warf sich mit aller Kraft gegen die Tür, doch schon schleuderte ihn ein teuflischer Aufwärtshaken in Harrys Schoß.
freilich	of course	Der Wagen freilich war nun am Ende seiner Kräfte.
spöttisch	mocking	Der grausame, spöttische und bei allen außer bei den Schülern seines eigenen Hauses (Slytherin) unbeliebte Snape unterrichtete Zaubertränke.
gekündigt	cancelled	»Vielleicht hat er gekündigt«, entgegnete Harry, »weil er wieder nicht Verteidigung gegen die dunklen Künste unterrichten darf!«
das Einmachglas	preserving jar	An den dunklen Wänden zogen sich Regale voller großer Einmachgläser entlang, in denen alle möglichen widerwärtigen Geschöpfe schwammen, deren Namen Harry im Moment nicht wußte.
das Geschöpf	creature	An den dunklen Wänden zogen sich Regale voller großer Einmachgläser entlang, in denen alle möglichen widerwärtigen Geschöpfe schwammen, deren Namen Harry im Moment nicht wußte.
das Trara	razzmatazz	Wollten hier mit großem Trara ankommen, nicht Wahr, die Herren« »Nein, Sir, die Absperrung in King’s Cross, sie«– »Ruhe«, sagte Snape kühl.
felsenfest	firm	»Zwei Londoner Muggel sind felsenfest überzeugt, daß sie einen alten Wagen über den Turm des Postamtes fliegen sahen« Als Mrs Hetty Bayliss in Norfolk um die Mittagszeit ihre Wäsche aufhängen wollte« Mr Angus Fleet aus Peebles schilderte der Polizei« Sechs bis sieben Muggel insgesamt.
überzeugt	convinced	»Zwei Londoner Muggel sind felsenfest überzeugt, daß sie einen alten Wagen über den Turm des Postamtes fliegen sahen« Als Mrs Hetty Bayliss in Norfolk um die Mittagszeit ihre Wäsche aufhängen wollte« Mr Angus Fleet aus Peebles schilderte der Polizei« Sechs bis sieben Muggel insgesamt.
das Bedauern	a regret	»Zu meinem größten Bedauern gehört ihr nicht zu meinem Haus, und die Entscheidung, euch von der Schule zu weisen, ist nicht meine Sache.
das Unheil	disaster	»Ich wünsche eine Erklärung«, sagte sie mit Unheil verkündend schimmernden Brillengläsern.
die Schilderung	description	Ron stürzte sich in die Schilderung ihrer Erlebnisse und begann bei der Absperrung, die sie nicht durchlassen wollte. »– also hatten wir keine Wahl, Professor, wir konnten den Zug nicht erreichen.«
das Erlebnis	experience	Ron stürzte sich in die Schilderung ihrer Erlebnisse und begann bei der Absperrung, die sie nicht durchlassen wollte. »– also hatten wir keine Wahl, Professor, wir konnten den Zug nicht erreichen.«
bestürzen	(to) dismay	Harry sah sie bestürzt an.
spuren	(to) feel	Harry spürte seinen ganzen Körper taub werden.
taub	deaf	Harry spürte seinen ganzen Körper taub werden.
die Enttäuschung	disappointment	Die Enttäuschung, die in Dumbledores Stimme lag, gefiel Harry überhaupt nicht.
die Schwindel (pl.)	fake	Daß Dumbledore diesen Schwindel sofort durchschauen würde, war ihm klar, doch Dumbledore wollte nichts weiter über den Wagen wissen.
einschärfen	(to) imprint	»Doch ich muß Ihnen nachdrücklich einschärfen, daß Ihr Handeln ein schwerer Fehler war.
absagen	(to) cancel	Snape sah aus, als wäre Weihnachten abgesagt worden.
die Vorschrift	instruction	Er räusperte sich und sagte:»Professor Dumbledore, diese Jungen haben die Vorschriften zur Einschränkung der Zauberei Minderjähriger gebrochen und einen wertvollen alten Baum schwer beschädigt« gewiß müssen derlei Taten«– »Es ist Sache von Professor McGonagall, über die Strafen für die Jungen zu befinden, Severus«, sagte Dumbledore gelassen.
beschädigen	damage	Er räusperte sich und sagte:»Professor Dumbledore, diese Jungen haben die Vorschriften zur Einschränkung der Zauberei Minderjähriger gebrochen und einen wertvollen alten Baum schwer beschädigt« gewiß müssen derlei Taten«– »Es ist Sache von Professor McGonagall, über die Strafen für die Jungen zu befinden, Severus«, sagte Dumbledore gelassen.
die Obhut	care	»Sie gehören zu ihrem Haus und stehen daher in ihrer Obhut.
versetzen	(to) displace	Professor McGonagall versetzte ihm einen durchdringenden Blick, doch er war sich sicher, den Anflug eines Lächelns zu erkennen. jedenfalls sah ihr Mund nicht mehr ganz so schmal aus.
die Achseln (pl.)	shoulders	Harry zuckte die Achseln.
zerren	(to) drag	Mit Genugtuung stellte er fest, daß sein Foto-Ich es Lockhart mehr als schwer machte und sich partout nicht ins Blickfeld zerren ließ.
feixen	smirk	Und hinter den sechs stämmigen Gestalten vor ihnen kam ein siebter, kleinerer Junge zum Vorschein, über das ganze bleiche, spitze Gesicht feixend.
das Gebüsch	bushes	»Schnell, da rüber«, zischte Harry und zerrte Ron hinter ein nahes Gebüsch.
leibhaftig	in person	Harry zupfte seinen Umhang zurecht und suchte sich einen Platz ganz hinten, wo er sich damit beschäftigte, alle sieben Bücher von Lockhart vor sich aufzustapeln, so daß er den leibhaftigen Lockhart nicht anzusehen brauchte.
hauchzart	extremely delicate	Gilderoy Lockhart kam herausgeschritten, heute in einem hauchzart malvenfarben getönten Umhang.
das Eingeweide	guts	Seine Eingeweide brannten vor Schuldgefühlen.
füttern	(to) feed	Wenn davon auch nur ein Wort wahr ist, futtere ich meinen Kessel auf.«
aufschlitzen	(to) slit open	Wenn du den halben Kopf aufgeschlitzt kriegst, macht dich das noch lange nicht zu was Besonderem, wenn du mich fragst.«
die Raupe	caterpillar	Wood zückte seinen Zauberstab, tippte auf die Tafel, und die Pfeile begannen über den Plan zu krabbeln wie Raupen.
ehrfurchtsvoll	reverent	»Und du bist der Sucher von Gryffindor, nicht?«, sagte Colin ehrfurchtsvoll. »ja«, sagte Harry, als sie aus dem Schloßtor gingen und sich auf den Weg über den taugetränkten Rasen machten.
zwinkern	(to) wink	»Er zwinkerte Harry kumpelhaft zu und schritt davon.
kullern	(to) roll	Ein heftiges Würgen, und noch mehr Schnecken kullerten Ron den Bauch hinunter.
ekelhaft	disgusting	Ich will doch keine ekelhafte Narbe quer über mein Gesicht haben, nein danke.
der Schwamm	sponge	Sein Hirn fühlte sich wie ein ausgedrückter Schwamm an.
kumpelhaft	matey	»Er zwinkerte Harry kumpelhaft zu und schritt davon.
die Beule	dent, bump	Am Freitagmorgen übertraf er sich selbst: Pfeilschnell schoß er aus Rons Hand, flog genau zwischen die Augen des kleinen alten Professor Flitwick und hinterließ dort eine große, pulsierende grüne Beule.
der Findling	boulder	Auf dem kleinen Gemüsebeet hinter Hagrids Haus wuchsen ein Dutzend der größten Kürbisse, die Harry je gesehen hatte. jeder war so groß wie ein mächtiger Findling.
die Weide	willow	Professor Sprout trug einen Arm voll Mullbinden, und mit einem erneuten Anflug von Schuldgefühlen erkannte Harry in der Ferne die Peitschende Weide, die nun etliche Zweige in Bandagen hatte.
der Bann	a spell	Er starrte Harry an, als stünde er unter einem Bann.
der Knall	a crack	Ein lauter Knall hallte im Stadion wider, ein grüner Lichtstrahl schoß aus dem falschen Ende von Rons Zauberstab heraus, traf ihn in den Magen und schleuderte ihn in hohem Bogen rücklings ins Gras.
ausrasten	(to) disengage	»Malfoy hat Hermine beschimpft – muß wirklich schlimm gewesen sein, denn alle sind ausgerastet «– »Es war schlimm«, sagte Ron heiser und tauchte bleich und schwitzend über der Tischplatte auf, »Malfoy hat sie &gt;Schlammblut(genannt, Hagrid.«
die Herrschaften (pl.)	ladies &amp; gentlemen	»Um was geht es denn, Herrschaften?
spotten	mock	»Weasley hätte gern eine Autogrammkarte, Potter«, spottete Malfoy, »sie wäre mehr wert als das ganze Haus seiner Familie «– Blitzschnell zog Ron seinen geflickten Zauberstab hervor, doch Hermine schlug Abstecher mit Vampiren knallend zu und flüsterte: »Schau mal, wer da kommt!«
der Auflauf	baked dish	Harry schmeckte sein Auflauf mit Hackfleisch und Kartoffeln nicht so gut, wie er erwartet hatte.
die Fühler (pl.)	feeler	Bei diesen Worten versetzte sie einer dornigen, dunkelroten Pflanze, deren lange Fühler sich still und leise über ihre Schulter gestohlen hatten, einen heftigen Klaps, und die Fühler wichen rasch zurück.
die Missbilligung	disapproval	»Ein Schwellzauber, nehme ich an?«, sagte Hermine, hin-und hergerissen zwischen Mißbilligung und Vergnügen.
der Wichtel	brownie	»Ja«, sagte er mit theatralischer Stimme, »frisch gefangene Wichtel aus Cornwall.«
die Mullbinde	bandage	Professor Sprout trug einen Arm voll Mullbinden, und mit einem erneuten Anflug von Schuldgefühlen erkannte Harry in der Ferne die Peitschende Weide, die nun etliche Zweige in Bandagen hatte.
gehässig	spiteful	Und was die alten Sauberwischs angeht«- gehässig lächelte er Fred und George an, die ihre Sauberwischs Fünf in Händen hielten -»damit könnt ihr die Tafel wischen.«
das Würgen	choking	Ein heftiges Würgen, und noch mehr Schnecken kullerten Ron den Bauch hinunter.
untersetzt	lumpish, stocky	Professor Sprout war eine untersetzte kleine Hexe mit einem Flickenhut auf ihrem windzerzausten Haar; meist hatte sie eine ganze Menge Erde auf den Kleidern, und beim Anblick ihrer Fingernägel wäre Tante Petunia in Ohnmacht gefallen.
türkisfarben	turquoise	Tadellos gekleidet war dagegen Gilderoy Lockhart mit seinem wehenden türkisfarbenen Umhang.
zustande bringen	bring about, achieve	Sie zeigte ihnen eine Hand voll Mantelknöpfe, die sie in Verwandlung zustande gebracht hatte.
frösteln	feel chilly	»Von den andern Mannschaften hat noch keine mit dem Training angefangen, dieses Jahr sind wir die Ersten in den Startlöchern «– Gähnend und ein wenig fröstelnd stieg Harry aus dem Bett und machte sich auf die Suche nach seinem Quidditch-Umhang.
sausen	whiz	Mit vollem Karacho sauste er um das Stadion und jagte Fred und George hinterher.
löchern	(to) bombard, bother	Doch Colin hörte nicht auf, Harry den ganzen Weg über den Rasen hinunter zum Quidditch-Feld mit Fragen zu löchern, und Harry konnte ihn erst abschütteln, als sie die Umkleidekabinen erreicht hatten.
der Ansturm	onslaught	»Oh, sieh mal«, sagte Flint, »was für ein Ansturm.«
emsig	industrious	»Schon wenn man in Form ist, ist das ein schwieriger Fluch, aber mit einem zerbrochenen Zauberstab «– Hagrid war emsig damit beschäftigt, ihnen Tee zu kochen.
der Schraubstock	vice	Harry, wie mit einem Schraubstock an Lockhart gepreßt, sah Malfoy mit spöttischem Blick in der Menge verschwinden.
ein Hühnchen rupfen	to discuss something	»Harry«, sagte Hagrid, als ob ihm plötzlich etwas eingefallen wäre, »mit dir muß ich noch ein Hühnchen rupfen.
flackern	flicker	Malfoys blasiertes Gesicht begann zu flackern.
unverkennbar	unmistakable	Auf meinen Reisen sind mir nur zufällig einige dieser Exoten begegnet«– »Gewächshaus drei heute, Freunde«, sagte Professor Sprout, die nicht wie sonst immer fröhlich, sondern unverkennbar miesepetrig dreinsah.
verscheuern	sell off	Ihr könntet eure Sauberwischs Fünf verscheuern, vielleicht hat ein Museum Interesse dran.«
der Taugenichts	good-for-nothing	»Ah, da ist ja der kleine Taugenichts!«, sagte er.
blasierte Miene	smug face	»Ich bin der neue Sucher der Slytherins, Weasley«, sagte Malfoy mit blasierter Miene.
räumen	clear [away]	»Hat mich beraten, wie man Wassergeister aus einer Quelle rauskriegt«, brummte Hagrid, dabei räumte er einen halb gerupften Hahn vom geschrubbten Tisch und setzte den Teekessel auf.
partout	at all costs	Mit Genugtuung stellte er fest, daß sein Foto-Ich es Lockhart mehr als schwer machte und sich partout nicht ins Blickfeld zerren ließ.
die Genugtuung	gratification	Mit Genugtuung stellte er fest, daß sein Foto-Ich es Lockhart mehr als schwer machte und sich partout nicht ins Blickfeld zerren ließ.
der Namenszug	signature	Ein paar der Bilder hatte er sogar mit seinem Namenszug versehen.
gönnerhaft	patronizing	Harry wollte gerade den Mund aufmachen, doch Lockhart patschte ihm den Arm auf die Schulter und dröhnte gönnerhaft: »Dumme Frage!
knallrot	bright red	Hermine riß ihm den Stundenplan aus der Hand und wurde knallrot.
strahlen	(to) beam	Prompt flog die Tür auf Lockhart strahlte auf ihn herab.
gemein	coarse	Natürlich hab ich mitgekriegt, daß es wirklich übel war «– »Das ist so ziemlich das Gemeinste, was ihm einfallen konnte«, keuchte Ron und tauchte wieder auf.
heiser	hoarse	»Malfoy hat Hermine beschimpft – muß wirklich schlimm gewesen sein, denn alle sind ausgerastet «– »Es war schlimm«, sagte Ron heiser und tauchte bleich und schwitzend über der Tischplatte auf, »Malfoy hat sie &gt;Schlammblut(genannt, Hagrid.«
das Schimpfwort	insult	»Schlammblut ist ein wirklich schlimmes Schimpfwort für jemanden, der aus einer Muggelfamilie stammt – du weißt ja, mit Eltern, die keine Zauberer sind.
unscheinbar	inconspicuous	Harry, der nicht die geringste Ahnung hatte, was Hermine mit dem»Schrei»der Alraune meinte, fand die Gewächse recht unscheinbar.
zur Neige	to the very tips	Die Kerzen brannten zur Neige und warfen ihr flackerndes Licht über die vielen Gesichter Lockharts, die Harry ansahen.
der Begleiter	companion	Hin und wieder fing er einen Satz auf wie:»Ruhm ist ein tückischer Begleiter, Harry«, oder:»Berühmt sein heißt, ruhmreich zu handeln, merken Sie sich das.«
miesepetrig	in a bad mood	Auf meinen Reisen sind mir nur zufällig einige dieser Exoten begegnet«– »Gewächshaus drei heute, Freunde«, sagte Professor Sprout, die nicht wie sonst immer fröhlich, sondern unverkennbar miesepetrig dreinsah.
das Knochenmark	bone marrow	Es war eine Stimme, eine Stimme, die ihm das Knochenmark gefrieren ließ, eine Stimme, erfüllt von eiskaltem Haß.
das Gedächtnis	memory	Neville war ein rundgesichtiger und unfallträchtiger Junge mit dem schlechtesten Gedächtnis von allen Menschen, die Harry jemals kennen gelernt hatte.
schüchtern	shy	»Hallo, Harry, Ich bin« ich bin Colin Creevey«, sagte er atemlos und machte einen schüchternen Schritt auf ihn zu.
kraxeln	climb	Und Colin kraxelte hinter ihm her.
Los ziehen	to draw a lot	Beide waren fest davon überzeugt, das schlechtere Los gezogen zu haben.
die Grabesstille	deathly silence	Grabesstille machte sich breit.
flauschig	fluffy	Es gab ein Gerangel, weil alle versuchten ein Paar zu bekommen, das nicht rosa und flauschig war.
der Kronleuchter	chandelier	Sie packten Tintenfässer und spritzten damit in der Klasse herum, zerfetzten Bücher und Papiere, rissen Bilder von den Wänden, stülpten den Papierkorb um, packten Taschen und Bücher und warfen sie aus dem zerborstenen Fenster; nach ein paar Minuten nahmen die Schüler unter ihren Tischen Deckung und Neville pendelte vom Kronleuchter an der Decke.
missbilligen	disapprove of	Ihr»Morgen«-Gruß klang ein wenig steif, und Harry spürte, daß sie immer noch die Art und Weise, wie er und Ron nach Hogwarts gelangt waren, missbilligte.
die Flutwelle	tidal wave	Harry und Ron saßen sprachlos da, als wäre eine Flutwelle über sie hinweggegangen.
lästig	tiresome	»Da wär ich mir nicht so sicher!«, sagte Lockhart und fuchtelte lästig mit dem Finger vor Seamus’ Nase herum.
gefrieren	freeze	Es war eine Stimme, eine Stimme, die ihm das Knochenmark gefrieren ließ, eine Stimme, erfüllt von eiskaltem Haß.
der Dämmerschlaf	half-sleep	»So«, sagte Wood endlich und riß Harry aus einem wohligen Dämmerschlaf, in dem er sich vorstellte, was er in diesem Augenblick oben im Schloß zum Frühstück verspeisen könnte.
ohrfeigen	slaps in the face	Ich hätte mich ohrfeigen können.«
erstaunlicherweise	astonishingly	Erstaunlicherweise konnte er jeden einzelnen seiner blitzenden Zähne zeigen, selbst wenn er nicht sprach.
bedrückt	depressed	»Ich glaube, wir können nichts tun außer abwarten, bis es aufhört«, sagte Hermine bedrückt, während sich Ron über die Wanne beugte.
zerfetzen	rip to pieces	»Komm« komm zu mir« laß mich dich zerreißen« laß mich dich zerfetzen« laß mich dich töten«– Harry fiel fast vom Stuhl und ein großer lila Fleck breitete sich auf Veronica Smethleys Straße aus.
flehentlich	pleadingly	Und es wär echt gut, wenn ich eins von dir hätte -»er sah Harry flehentlich bittend an«- vielleicht könnte dein Freund es schießen und ich stelle mich neben dich?
verkrümeln	slip off	Colin fummelte an seiner Kamera und schoß das Bild in dem Augenblick, als die Glocke hinter ihnen läutete und zum Nachmittagsunterricht rief »So, die Herrschaften, verkrümelt euch«, rief Lockhart den Umstehenden zu und ging mit Harry, den er immer noch an sich gepreßt hatte, auf das Schloßtor zu.
schalkhaft	roguish	Er zwinkerte ihnen erneut schalkhaft zu.
der Rülpser	belch	Stattdessen gab er einen dröhnenden Rülpser von sich, und ein Dutzend Schnecken kullerten ihm aus dem Mund in den Schoß.
krümmen	bend	Die Slytherins krümmten sich vor Lachen.
schnattern	(to) chatter	Tatsächlich hatte sich Harry gerade über seinen Haferbrei hergemacht, als auch schon ein Rauschen über ihren Köpfen zu hören war und gut hundert Eulen hereinströmten, in der Halle kreisten und Briefe und Päckchen in die schnatternde Schülerschar fallen ließen.
durchtrieben	crafty	Mit trollhaft durchtriebener Miene antwortete er:»Ist doch Platz genug für uns alle da, Wood.«
der Geschmack	taste	»Hab Sie auf den Geschmack gebracht, was öffentliches Aufsehen angeht, nicht wahr?«, sagte Lockhart.
redselig	talkative	Es war, als hätte er einen äußerst redseligen Schatten.
die Last	burden	Die vier langen Haustische unter der magischen Decke (heute in wolkig trübem Grau) ächzten unter ihrer Last aus Schüsseln mit Haferbrei, Platten voll geräuchertem Hering, Tellern mit Eiern und Schinken und Bergen von Toastbrot.
bergab	downhill	Vom Frühstück in der Großen Halle an ging es bergab.
der Waffenrock	tunic	Er trug einen eleganten Federhut auf dem langen Lockenhaar und einen Waffenrock mit Halskrause, so daß man nicht sehen konnte, daß sein Hals fast ganz durchtrennt war.
das Aufsehen	sensation	»Hab Sie auf den Geschmack gebracht, was öffentliches Aufsehen angeht, nicht wahr?«, sagte Lockhart.
der Dampf	steam	Er war blaß wie Dampf und Harry sah durch ihn hindurch nach draußen auf den dunklen Himmel und die Sintflut, die sich aus ihm ergoß.
flankieren	flank	Er hatte sich direkt hinter Colin gestellt, flankiert, wie immer in Hogwarts, von seinen grobschlächtigen und brutalen Spießgesellen Crabbe und Goyle.
die Sintflut	the Flood	Er war blaß wie Dampf und Harry sah durch ihn hindurch nach draußen auf den dunklen Himmel und die Sintflut, die sich aus ihm ergoß.
heimtückisch	malicious	Es ist meine Aufgabe, euch gegen die heimtückischsten Geschöpfe zu wappnen, die die Zaubererwelt kennt!
die Angelegenheit	matter	»Sie ebenfalls«, sagte Harry; »Ah«, sagte der Fast Kopflose Nick mit eleganter Handbewegung, »eine Angelegenheit ohne Bedeutung« nicht, daß ich wirklich Mitglied werden wollte« dachte, ich bewerbe mich mal, doch offenbar genüge ich &gt;nicht den Anforderungen&lt;.«
schneiden	(to) cut	Laut und schneidend hallte Draco Malfoys Stimme im ganzen Hof wider.
das Mitglied	member	»Sie ebenfalls«, sagte Harry; »Ah«, sagte der Fast Kopflose Nick mit eleganter Handbewegung, »eine Angelegenheit ohne Bedeutung« nicht, daß ich wirklich Mitglied werden wollte« dachte, ich bewerbe mich mal, doch offenbar genüge ich &gt;nicht den Anforderungen&lt;.«
der Schnupfen	the sniffles	»Sie verschwinden gam besten von hier, Harry«, sagte Nick hastig, »Filch hat ganz schlechte Laune – er hat einen Schnupfen, und ein paar Drittkläßler haben in Kerker fünf versehentlich Froschgehirne über die ganze Decke gespritzt, er hat den ganzen Morgen geputzt, und wenn er Sie hier vor Schlamm triefen sieht «– »Stimmt«, sagte Harry und wich vor dem anklagenden Starren von Mrs Norris zurück, doch nicht schnell genug.
der Schlamm	mud	»Sie verschwinden gam besten von hier, Harry«, sagte Nick hastig, »Filch hat ganz schlechte Laune – er hat einen Schnupfen, und ein paar Drittkläßler haben in Kerker fünf versehentlich Froschgehirne über die ganze Decke gespritzt, er hat den ganzen Morgen geputzt, und wenn er Sie hier vor Schlamm triefen sieht «– »Stimmt«, sagte Harry und wich vor dem anklagenden Starren von Mrs Norris zurück, doch nicht schnell genug.
triefen	drip	»Sie verschwinden gam besten von hier, Harry«, sagte Nick hastig, »Filch hat ganz schlechte Laune – er hat einen Schnupfen, und ein paar Drittkläßler haben in Kerker fünf versehentlich Froschgehirne über die ganze Decke gespritzt, er hat den ganzen Morgen geputzt, und wenn er Sie hier vor Schlamm triefen sieht «– »Stimmt«, sagte Harry und wich vor dem anklagenden Starren von Mrs Norris zurück, doch nicht schnell genug.
die Abschreckung	discouragement	»Dreck«, murmelte er zornig, »große, glühend heiße Drachenpopel« Froschgehirne« Ratteninnereien« mir reicht’s« Strafe zur Abschreckung« wo ist das Formblatt« da«– Er hatte eine dicke Rolle Pergament aus der Schreibtischschublade gezogen und sie vor sich ausgebreitet und tunkte nun den langen schwarzen Federkiel in das Tintenfaß.
der Dunstschleier	veil of haze	Die Slytherins jagten durch die Luft wie Senkrechtstarter, so berichteten sie, und seien nur noch als sieben grünliche Dunstschleier auszumachen.
senkrecht	vertical	Die Slytherins jagten durch die Luft wie Senkrechtstarter, so berichteten sie, und seien nur noch als sieben grünliche Dunstschleier auszumachen.
Vergünstigung	privilege, benefit	»Es wäre angeraten, ihm gewisse Vergünstigungen zu entziehen, bis er bereit ist, uns die ganze Geschichte zu erzählen.
zuverlässig	reliable	»Zuverlässige historische Quellen sagen uns jedenfalls so viel«, sagte er.
beiläufig	casual	»Hallo, Colin«, sagte Harry beiläufig.
überwuchern	(to) overgrow	»Doch diese klaren Tatsachen werden überwuchert durch die phantasiereiche Legende von der Kammer des Schreckens.
unschuldig	innocent	»Unschuldig bis zum Beweis der Schuld, Severus«, sagte er entschieden.
grantig	bad-tempered	»Ich kann da nicht rein«, sagte Ron grantig.
halblang	mid-length	»Nun mal halblang, Severus«, sagte Professor McGonagall scharf, »ich sehe keinen Grund, dem Jungen das Quidditch zu verbieten.
teigig	doughy	»Dafür wäre schwarze Magie der fortgeschrittensten «– »Er hat’s getan, er hat’s getan«, keifte Filch, und sein teigiges Gesicht lief purpurrot an.
rauschen	rush	Im Nu rauschte er an Harry, Ron und Hermine vorbei und holte Mrs Norris vom Fackelhalter.
die Alraune	mandrake	»Meine Katze ist versteinert worden!«, kreischte er mit hüpfenden Augenbällen, »ich will eine Bestrafung sehen« »Wir werden sie heilen können, Argus«, sagte Dumbledore geduldig, »Madam Sprout ist es kürzlich gelungen, einige Alraunen zu züchten.
zufolge	according to	Dieser zufolge hat Slytherin eine Geheimkammer in das Schloß eingebaut, von der die anderen Gründer nichts wußten.
der Beweis	prove	Es gibt keinerlei Beweise dafür, daß Potter etwas Unrechtes getan hat.«
röntgen	X-ray	Seine blinkenden hellblauen Augen gaben Harry das Gefühl, geröntgt zu werden.
prüfen	test	Dumbledore sah Harry prüfend an.
das Bewusstsein	awareness	»Ich habe Mrs Norris nicht einmal angefasst!«, sagte Harry laut und im Bewusstsein, daß ihn alle ansahen, auch alle Lockharts an den Wänden.
starren	stare	Mit einem Funkeln in den kalten Augen, das sonst blutleere Gesicht gerötet, grinste er beim Anblick der starren Katze.
der Klecks	blot	Als er gedankenverloren nach seinem Zauberstab griff, um die Kleckse zu entfernen, fing das Pergament Feuer.
gequält	tormented	Er hat – in meinem Büro – er weiß, daß ich ein – ich ein -»in Filchs Gesicht trat etwas fürchterlich Gequältes, »er weiß, daß ich ein Squib bin«, stieß er hervor.
versiegeln	seal	Und die Legende sagt weiter, daß Slytherin diese Kammer versiegelt hat, so daß keiner sie öffnen kann, bis sein eigener wahrer Erbe zur Schule kommt.
ungehalten	annoyed	Professor Binns sah ein wenig ungehalten aus.
das Kinn	chin	Die Maulende Myrte schwebte über der Kloschüssel und drückte an einem Pickel auf ihrem Kinn herum.
umstehen	(to) stand round	»Potter und seine Freunde waren vielleicht nur zur falschen Zeit am falschen Ort«, sagte er, und seine Lippen kräuselten sich in einem Anflug von Häme, als ob er dies bezweifelte, »aber wir haben hier eine Reihe von verdächtigen Umständen.
das Maßband	measure band	»Wo ist sie?«, fragte Harry, griff sich das Maßband und entrollte seine eigene Hausarbeit.
beflissen	keen	Beflissen trat Lockhart vor.
furchteinflößend	frightening	Aber ich würde meinen – schaut euch den Kerl doch mal an «– »Ich denke«, sagte Harry rasch auf einen bedeutungsvollen Blick von Nick hin, »Nick ist sehr – furchteinflößend und – ähm «– »Ha!«, rief Sir Patricks Kopf, »wette, er hat Sie gebeten, das zu sagen!«
blühend	flourishing	»Die ganze Geschichte ist natürlich blühender Unsinn«, sagte er.
die Vorahnung	foreboding	»Wenn ich etwas dazu sagen darf, Direktor«, sagte Snape aus dem Schatten heraus, und Harrys ungute Vorahnung verstärkte sich; gewiß würde Snape nichts zu sagen haben, was ihm helfen könnte.
der Unterkiefer	lower jaw	Dean Thomas, der mit herabhängendem Unterkiefer dagesessen und aus dem Fenster gestarrt hatte, schreckte aus seiner Trance; Lavender Brown riß den Kopf von ihren Armen und Nevilles Ellbogen rutschte vom Tisch.
unangenehm	unpleasant	Die Stimmung war unangenehm gespannt, denn alle sahen ihn an und warteten auf mehr.
verdutzt	taken aback	Professor Binns, inmitten eines sterbenslangweiligen Vortrags über die Internationale Zaubererversammlung von 1289, schaute verdutzt auf.
der Schrecken	fright	Der Erbe allein soll in der Lage sein, die Kammer des Schreckens zu entsiegeln, den Schrecken im Innern zu entfesseln und mit seiner Hilfe die Schule von all jenen zu säubern, die es nicht wert seien, Zauberei zu studieren.«
verdächtigen	suspect	»Potter und seine Freunde waren vielleicht nur zur falschen Zeit am falschen Ort«, sagte er, und seine Lippen kräuselten sich in einem Anflug von Häme, als ob er dies bezweifelte, »aber wir haben hier eine Reihe von verdächtigen Umständen.
trübe	cloudy	Der Boden war feucht und spiegelte trübe das Licht einiger Kerzenstummel wider, die in ihren Haltern ausbrannten; von den zerkratzten Holztüren der Kabinen schälte sich die Farbe ab und eine hing in den Angeln.
der Pickel	pimple	Die Maulende Myrte schwebte über der Kloschüssel und drückte an einem Pickel auf ihrem Kinn herum.
erben	heirs	FEINDE DES ERBEN, NEHMT EUCH IN ACHT »Was hängt – dadrunter?«, fragte Ron mit leichtem Zittern in der Stimme.
kräuseln	(to) frizz	»Potter und seine Freunde waren vielleicht nur zur falschen Zeit am falschen Ort«, sagte er, und seine Lippen kräuselten sich in einem Anflug von Häme, als ob er dies bezweifelte, »aber wir haben hier eine Reihe von verdächtigen Umständen.
die Wasserlache	puddle [of water]	Harry rutschte beinahe aus – auf dem Boden war eine große Wasserlache; Ron und Hermine hielten ihn fest und gemeinsam näherten sie sich der Schrift an der Wand, die Augen auf den dunklen Schatten darunter gerichtet.
lauten	lutes	»Ich brauch doch nur noch sechs Zentimeter, nun komm schon «– Es läutete.
hanebüchen	outrageous	Ich bereue es, Ihnen eine so hanebüchene Legende erzählt zu haben!
Reißaus	heels	Harry erzählte Ron, daß Justin Finch-Fletchley vor ihm Reißaus genommen habe.
bloke	(to) bleat	»Der müßte schon ziemlich blöde sein.«
empfinden (für jmdm)	(to) to feel for someone	Sosehr er Filch verabscheute, Harry konnte nicht anders, er empfand ein wenig Mitleid für ihn, wenn auch nicht so viel wie für sich selbst.
unheimlich	terrifically	»Aber, du mußt zugeben, es ist unheimlich«– »Ich weiß, es ist unheimlich«, sagte Harry.
reißerisch	sensational	»Allerdings ist die Legende, von der Sie sprechen, eine derart reißerische, geradezu lächerliche Geschichte «– Doch nun hing die ganze Klasse an Professor Binns’ Lippen.
erbost	infuriate	»Das hab ich auch Ginny gesagt«, sagte Percy erbost, »aber sie denkt offenbar immer noch, daß ihr von der Schule fliegt, ich hab sie nie so aufgeregt gesehen, sie heult sich die Augen aus, denk doch mal an sie, alle Erstkläßler sind wegen dieser ganzen Geschichte völlig aus dem Häuschen «– »Dir ist Ginny doch egal«, sagte Ron, und die Ohren liefen ihm jetzt rot an.
trocken	dry	
fähig	able	Er war auf einem Stuhl neben dem Schreibtisch zusammengesunken, das Gesicht in den Händen vergraben und nicht fähig, einen Blick auf Mrs Norris zu werfen.
Abschaum	scum	»Überlegen wir mal«, sagte Ron mit gespielter Ratlosigkeit, »wer, den wir kennen, denkt, Muggelkinder seien Abschaum?«
zypriotisch	Cypriot	»Er räusperte sich, was sich anhörte wie zerbrechende Kreide, und fuhr fort:»im September jenes Jahres hat ein Unterausschuss zyprischer Zauberer «– Er verhaspelte sich und brach ab.
Bücke	stoop	Harry, Ron und Hermine tauschten gespannte Bücke und setzten sich auf Stühle außerhalb des Kerzenscheins.
Weise	show	»Haben uns nur ein wenig umgesehen«, meinte Ron achselzuckend, »Spuren, weißt du «– Percy schwoll auf eine Weise an, die Harry stark an Mrs Weasley erinnerte.
Auslassung	omission	Ich kenne nämlich den Gegenfluch, der sie gerettet hätte«– Während Lockharts Auslassungen waren immer wieder Filchs trockene, markerschütternde Schluchzer zu hören.
wachsam	watchful	Hinter ihnen im Halbschatten stand Snape, wachsam und mit einem höchst merkwürdigen Gesichtsausdruck: als ob er angestrengt versuchte nicht zu lächeln.
achselzuckend	shrugging	»Haben uns nur ein wenig umgesehen«, meinte Ron achselzuckend, »Spuren, weißt du «– Percy schwoll auf eine Weise an, die Harry stark an Mrs Weasley erinnerte.
eifrig	eager	Ehrlich gesagt, wenn der Sprechende Hut versucht hätte, mich nach Slytherin zu stecken, hätte ich gleich wieder den Zug nach Hause genommen«– Hermine nickte eifrig, doch Harry sagte kein Wort.
Angriff	attack	Ein paar Tage lang sprachen sie in der Schule von nichts anderem als vom Angriff auf Mrs Norris.
schwellen	thresholds	»Haben uns nur ein wenig umgesehen«, meinte Ron achselzuckend, »Spuren, weißt du «– Percy schwoll auf eine Weise an, die Harry stark an Mrs Weasley erinnerte.
Zipfel	corner	Es gibt rächt den Zipfel eines Beweises, daß Slytherin auch nur einen geheimen Besenschrank gebaut hat!
rächen	avenge	Es gibt rächt den Zipfel eines Beweises, daß Slytherin auch nur einen geheimen Besenschrank gebaut hat!
ausstopfen	(to) stuff	Dumbledore murmelte jetzt seltsame Worte vor sich hin und tippte Mrs Norris mit seinem Zauberstab an, doch nichts passierte: sie sah weiterhin aus, als wäre sie gerade ausgestopft worden. »– ich kann mich an einen ganz ähnlichen Vorfall in Ouagadogou erinnern«, sagte Lockhart, »eine Serie von Attacken, nachzulesen in meiner Autobiographie; ich konnte die Dorfbevölkerung mit verschiedenen Amuletten ausstatten, und die Sache war sofort erledigt«– Die Lockharts an den Wänden nickten allesamt zustimmend.
Kreide	chalk	»Er räusperte sich, was sich anhörte wie zerbrechende Kreide, und fuhr fort:»im September jenes Jahres hat ein Unterausschuss zyprischer Zauberer «– Er verhaspelte sich und brach ab.
Verfolgung	pursuit	Sie haben dieses Schloß gemeinsam erbaut, fern von neugierigen Muggelaugen, denn es war ein Zeitalter, als das einfache Volk die Zauberei fürchtete und Hexen und Zauberer unter grausamer Verfolgung zu leiden hatten.«
bemüht	tries	Hermine bemühte sich offenbar immer noch, sich das Lachen zu verkneifen.
Staunen	amazement	Percy Weasley, mit glänzendem Vertrauensschülerabzeichen, stand wie angewurzelt am Treppenabsatz, mit dem Ausdruck ungläubigen Staunens auf dem Gesicht.
Lage	location	Der Erbe allein soll in der Lage sein, die Kammer des Schreckens zu entsiegeln, den Schrecken im Innern zu entfesseln und mit seiner Hilfe die Schule von all jenen zu säubern, die es nicht wert seien, Zauberei zu studieren.«
Bescheid	am content	»Die Klagende Witwe ist immerhin aus Kent angereist« es ist Zeit für meine Rede, ich geh lieber und sag dem Orchester Bescheid« e Das Orchester hörte jedoch in diesem Moment zu spielen auf.
einträchtig	harmonious	»Ein paar Jahre lang arbeiteten die Zauberer einträchtig zusammen.
gestanden	been	Harry und Ron standen mit offenen Mündern da, doch Hermine zuckte matt die Achseln und meinte:»Offen gestanden war das für Myrtes Verhältnisse eine fast fröhliche Unterhaltung« kommt, gehen wir.«
Verhältnis	relationship	Harry und Ron standen mit offenen Mündern da, doch Hermine zuckte matt die Achseln und meinte:»Offen gestanden war das für Myrtes Verhältnisse eine fast fröhliche Unterhaltung« kommt, gehen wir.«
Kluft	rig-out	Zwischen Slytherin und den andern tat sich eine wachsende Kluft auf.
Vorfall	incident	Dumbledore murmelte jetzt seltsame Worte vor sich hin und tippte Mrs Norris mit seinem Zauberstab an, doch nichts passierte: sie sah weiterhin aus, als wäre sie gerade ausgestopft worden. »– ich kann mich an einen ganz ähnlichen Vorfall in Ouagadogou erinnern«, sagte Lockhart, »eine Serie von Attacken, nachzulesen in meiner Autobiographie; ich konnte die Dorfbevölkerung mit verschiedenen Amuletten ausstatten, und die Sache war sofort erledigt«– Die Lockharts an den Wänden nickten allesamt zustimmend.
schrumplig	wrinkled	Er war uralt und schrumplig, und viele Leute sagten, er habe nicht bemerkt, daß er tot sei.
Mär	fable	Eine Mär, die dazu taugt, den Leichtgläubigen Furcht einzujagen.«
Staubsauger	vacuum cleaner	Professor Binns öffnete seine Unterlagen und begann dumpf dröhnend wie ein Staubsauger zu lesen, bis fast alle in der Klasse in einen Wachschlaf verfallen waren, nur gelegentlich aufmerkend, um einen Namen oder ein Datum zu notieren.
unterliegen	lose	Professor Binns öffnete seine Unterlagen und begann dumpf dröhnend wie ein Staubsauger zu lesen, bis fast alle in der Klasse in einen Wachschlaf verfallen waren, nur gelegentlich aufmerkend, um einen Namen oder ein Datum zu notieren.
Besessene	obsessive	Chapter 10: Der besessene Klatscher Seit der unrühmlichen Geschichte mit den Wichteln hatte Professor Lockhart keine lebenden Geschöpfe mehr in den Unterricht gebracht.
Geschehnis	event	Stattdessen las er ihnen aus seinem Buch vor und manchmal spielte er einige der dramatischeren Geschehnisse daraus nach.
Schnupfen	(to) sniff	So hatte er ihn schon genötigt, einen einfachen Dörfler aus Transsylvanien zu spielen, den Lockhart von einem Babbelfluch geheilt hatte, einen Yeti mit einem Schnupfen und einen Vampir, der, seit Lockhart sich ihn zur Brust genommen hatte, nichts mehr außer Kopfsalat essen konnte.
Kopfsalat	cabbage	So hatte er ihn schon genötigt, einen einfachen Dörfler aus Transsylvanien zu spielen, den Lockhart von einem Babbelfluch geheilt hatte, einen Yeti mit einem Schnupfen und einen Vampir, der, seit Lockhart sich ihn zur Brust genommen hatte, nichts mehr außer Kopfsalat essen konnte.
weigern	refuse	Er hätte sich am liebsten geweigert, doch hatte er einen sehr guten Grund, Lockhart bei Laune zu halten.
heulen	(to) howl	»Ein schönes lautes Heulen, Harry – genau – und dann, stellt euch vor, stürze ich mich auf ihn – wie jetzt – und drück ihn zu Boden – so – mit der einen Hand halte ich ihn unten – mit der andern steche ich den Zauberstab gegen seine Kehle – dann nehme ich meine letzten Kräfte zusammen und führe den immens komplizierten Homorphus-Zauber aus – der Werwolf fiept jämmerlich – weiter, Harry – noch höher -gut – der Pelz verschwindet – die Reißzähne schrumpfen – und er verwandelt sich zurück
Kehle	throat	»Ein schönes lautes Heulen, Harry – genau – und dann, stellt euch vor, stürze ich mich auf ihn – wie jetzt – und drück ihn zu Boden – so – mit der einen Hand halte ich ihn unten – mit der andern steche ich den Zauberstab gegen seine Kehle – dann nehme ich meine letzten Kräfte zusammen und führe den immens komplizierten Homorphus-Zauber aus – der Werwolf fiept jämmerlich – weiter, Harry – noch höher -gut – der Pelz verschwindet – die Reißzähne schrumpfen – und er verwandelt sich zurück in einen Menschen.
fiepen	whimper	»Ein schönes lautes Heulen, Harry – genau – und dann, stellt euch vor, stürze ich mich auf ihn – wie jetzt – und drück ihn zu Boden – so – mit der einen Hand halte ich ihn unten – mit der andern steche ich den Zauberstab gegen seine Kehle – dann nehme ich meine letzten Kräfte zusammen und führe den immens komplizierten Homorphus-Zauber aus – der Werwolf fiept jämmerlich – weiter, Harry – noch höher -gut – der Pelz verschwindet – die Reißzähne schrumpfen – und er verwandelt sich zurück in einen Menschen.
Brust	breast	Lockhart warf sich in die Brust.
Belohnung	reward	Mein Buch Magisches Ich mit Autogramm als Belohnung für das beste Gedicht!«
Teesieb	tea strainer	»Oja«, sagte Hermine respektvoll, »so schlau, wie Sie diesen letzten mit dem Teesieb gefangen haben «– »Nun, sicher wird niemand etwas dagegen haben, wenn ich meiner besten Schülerin in diesem Jahr noch ein wenig weiterhelfe«, sagte Lockhart herzlich und zückte einen riesigen Pfauenfederhalter. »ja, hübsch, nicht wahr?«, sagte er, Rons empörten Blick mißdeutend, »ich benutz ihn normalerweise nur, um Bücher zu signieren.«
brauchbar	useful	Wie ich höre, sind gSie ein brauchbarer Spieler.
Erfahrung	experience	Bin immer gern bereit, meine Erfahrung an weniger gute Spieler weiterzugeben«– Harry gab einen undeutlichen Kehllaut von sich und hastete dann Ron und Hermine nach.
Aufschneider	boaster	»Er ist eben ein hirnloser Aufschneider«, sagte Ron.
schrill	shrill	»Aber was soll’s, wir haben, was wir brauchen «– »Er ist kein hirnloser Aufschneider«, sagte Hermine schrill, und im Laufschritt machten sie sich auf den Weg in die Bibliothek.
reizbar	irritable	Madam Pince, die Bibliothekarin, war eine dürre, reizbare Gestalt, die aussah wie ein unterernährter Geier.
Geier	vulture	Madam Pince, die Bibliothekarin, war eine dürre, reizbare Gestalt, die aussah wie ein unterernährter Geier.
hauchen	breathe	»Ich würd es so gerne behalten«, hauchte sie.
staksen	stalk	Sie stakste davon und verschwand zwischen den hohen Regalen.
schimmlig	mouldy	Ein paar Minuten später kehrte sie mit einem großen, schimmlig aussehenden Buch zurück.
schuldbewusst	guilty	Hermine steckte es vorsichtig in die Tasche, und während sie die Bibliothek verließen, achteten sie sorgfältig darauf, nicht allzu schnell zu gehen oder zu schuldbewußt dreinzuschauen.
Einwand	objection	Hermine hatte sich gegen Rons Einwände durchgesetzt und darauf hingewiesen, daß dies der letzte Ort sei, den jemand aufsuchen würde, der noch alle Tassen im Schrank hatte.
geräuschvoll	noisy	Die Maulende Myrte weinte geräuschvoll in ihrer Kabine, doch sie beachteten sie nicht, und Myrte tat es ihnen gleich.
ausmalen	(to) colour in	Einige der Zaubertränke hatten derart gruslige Wirkungen, daß sie es sich lieber nicht ausmalten, und es gab einige gräuliche Abbildungen, darunter ein Mann, dessen Inneres nach außen gekehrt war, und eine Hexe, der etliche Arme aus dem Kopf sprossen.
graulich	scary	Einige der Zaubertränke hatten derart gruslige Wirkungen, daß sie es sich lieber nicht ausmalten, und es gab einige gräuliche Abbildungen, darunter ein Mann, dessen Inneres nach außen gekehrt war, und eine Hexe, der etliche Arme aus dem Kopf sprossen.
Knöterich	Polygonum	»Florfliegen, Blutegel, Flußgras und Knöterich«, murmelte sie und fuhr mit dem Finger über die Zutatenliste.
Schererei	trouble	Hermine sah nach, ob draußen vor dem Klo die Luft rein war, und Ron brummte Harry zu:»Wir hätten viel weniger Scherereien, wenn du Malfoy morgen einfach vom Besen hauen könntest.«
Überschwang	exuberance	Die Brust vor Überschwang geschwellt, wandte sich Wood an Harry.
Händedruck	handshake	Madam Hooch, die Quidditch-Lehrerin, forderte Flint und Wood zum Händedruck auf, und unter drohenden Blicken packten sie härter zu als nötig.
hartnäckig	obstinate	Klatscher verlegten sich nie so hartnäckig auf einen Spieler, es war ihre Aufgabe, so viele Leute wie möglich von den Besen zu werfen« Fred Weasley wartete am anderen Ende auf den Klatscher.
überlegen	(to) think	Er hatte keine Ahnung, was im Spiel sonst noch vor sich ging, bis er Lee Jordan, den Stadionsprecher, rufen hörte:»Slytherin in Führung, sechzig zu null Punkte «– Die überlegenen Besen der Slytherins taten eindeutig ihre Wirkung, während der verrückte Klatscher alles unternahm, um Harry vom Besen zu schlagen.
platt	flat	»Wir werden platt gemacht.
Ärmel	sleeve	»Hört mal zu«, sagte Harry, während Madam Hooch näher kam, »wenn ihr beide die ganze Zeit um mich herumfliegt, kann ich den Schnatz nur kriegen, wenn er mir den Ärmel hochsaust«, sagte Harry.
saudumm	saudumm	Komm schon, Oliver, sag ihnen, daß sie mich allein lassen sollen« »Das ist alles deine Schuld«, sagte George wutentbrannt zu Wood,«&gt;hol den Schnatz oder stirb bei dem Versuch&lt; – das war saudumm von dir, ihm das zu sagen.«
Schlaufe	strap	Er zog weite Schlaufen und legte Loopings ein, flog Spiralen und im Zickzack und rollte sich seitlich weg; ihm war leicht schwindlig, dennoch hielt der die Augen weit geöffnet; der Regen klatschte gegen seine Brille und lief ihm die Nase hoch, während er sich vom Besen hängen ließ, um einem weiteren tückischen Angriff des Klatschers auszuweichen.
zurück|treten	(to) step back	Er lieferte ihnen immer noch einen verbissenen Kampf, »Zurücktreten«, sagte Lockhart und rollte seine jadegrünen Ärmel hoch.
jadegrün	jade-green	Er lieferte ihnen immer noch einen verbissenen Kampf, »Zurücktreten«, sagte Lockhart und rollte seine jadegrünen Ärmel hoch.
Überrest	remnant	»Sie hätten gleich zu mir kommen sollen!«, tobte sie und hielt den traurigen lahmen Überrest dessen in die Höhe, was vor einer halben Stunde noch ein gesunder Arm gewesen war.
Vorhang	curtain	»Sie werden die Nacht Ober hier bleiben müssen«– Hermine wartete vor dem Vorhang um Harrys Bett, während Ron ihm in den Schlafanzug half Es dauerte eine Weile, bis der gummiartige, knochenlose Arm in einen Ärmel gestopft war.
unbeholfen	clumsy	»Alles in Ordnung«, sagte sie, während er sich mit der linken Hand unbeholfen Haferbrei in den Mund löffelte.
Lasche	loop	»Wie kannst du jetzt noch zu Lockhart halten, Hermine?«, rief Ron durch den Vorhang, während er Harrys lasche Finger durch den Ärmelaufschlag zog.
tragbar	portable	Tragbare, wasserdichte Feuer heraufzubeschwören, war eine Spezialität Hermines.
Rachen	pharynx	Es verbrannte Harry Mund und Rachen und ließ ihn husten und prusten.
verriegeln	(to) interlock	»Wir wären dich ja besuchen gekommen, aber dann haben wir beschlossen, mit dem Vielsaft-Zaubertrank anzufangen«, erklärte Ron, während Harry mühsam die Tür hinter sich verriegelte.
schmutzig	dirty	In diesem Augenblick ging die Tür des Krankenzimmers auf Schmutzig und durchnäßt stürmten die anderen aus der Gryffindor-Mannschaft herein und scharten sich um Harrys Bett.
Ausschau	lookout	»In der Tat, Sir«, sagte Dobby und nickte lebhaft und ohrenflatternd mit dem Kopf, »Dobby hat sich versteckt und nach Harry Potter Ausschau gehalten und den Durchgang verschlossen, ja, und danach mußte Dobby seine Hände schienen -»er zeigte Harry zehn lange verbundene Finger«- aber Dobby war es egal, Sir, denn er glaubte, Harry Potter sei sicher, und er hat sich nie träumen lassen, daß Harry Potter auf einem anderen Weg zur Schule kommen würde« Er schüttelte den häßlichen Kopf und wiegte vor und zurück.
verblüfft	baffled	Ron und Hermine hoben verblüfft die Köpfe.
schienen	tracks	»In der Tat, Sir«, sagte Dobby und nickte lebhaft und ohrenflatternd mit dem Kopf, »Dobby hat sich versteckt und nach Harry Potter Ausschau gehalten und den Durchgang verschlossen, ja, und danach mußte Dobby seine Hände schienen -»er zeigte Harry zehn lange verbundene Finger«- aber Dobby war es egal, Sir, denn er glaubte, Harry Potter sei sicher, und er hat sich nie träumen lassen, daß Harry Potter auf einem anderen Weg zur Schule kommen würde« Er schüttelte den häßlichen Kopf und wiegte vor und zurück.
schwirren	(to) whir	Plötzlich schwirrte die Luft von Gerüchten und Verdächtigungen. gDie Erstklässler gingen jetzt nur noch in Grüppchen durch das Schloss, als ob sie Angst hätten, angegriffen zu werden, wenn sie sich allein auf den Weg machten.
einsetzen	(to) insert	Ginny Weasley, die in Zauberkunst neben Colin Creevey gesessen hatte, war ganz verstört, doch Harry hatte den Eindruck, daß Fred und George das falsche Rezept einsetzten, um sie aufzumuntern.
anbrennen	(to) light	»Dobby war so entsetzt, als er hörte, daß Harry Potter zurück in Hogwarts war, daß er das Essen seines Herrn anbrennen ließ!
lauern	(to) lurk	Abwechselnd ließen sie sich Pelze oder Furunkel wachsen und lauerten ihr hinter Statuen auf, um ihr dann mitten in den Weg zu springen.
Tracht	strive	Eine solche Tracht Prügel hat Dobby noch nie bekommen, Sir«– Harry ließ sich auf die Kissen zurückfallen.
unterdessen	Meanwhile	Unterdessen kam es hinter dem Rücken der Lehrer zu einem blühenden Handel mit Talismanen, Amuletten und anderen schützenden Utensilien.
schnauben	(to) snort	»oh, ist das alles?«, sagte Harry schnaubend.
Ungeziefer	vermin	Wir Hauselfen wurden wie Ungeziefer behandelt, Sir!
der Handel	deal, business	Unterdessen kam es hinter dem Rücken der Lehrer zu einem blühenden Handel mit Talismanen, Amuletten und anderen schützenden Utensilien.
insgesamt	all in all	»Aber insgesamt, Sir, hat sich das Leben für unsereins verbessert, seit Sie über jenen, dessen Name nicht genannt werden darf, triumphiert haben.
verdächtig	suspicious	Harry, Ron und Hermine trugen sich in die Liste ein; sie hatten gehört, daß auch Malfoy dableiben würde, und das kam ihnen sehr verdächtig vor.
Bündel	bundle up	»Neben ihm lag ein Bündel Trauben«, sagte Professor McGonagall, »wir glauben, er hat versucht sich hier heraufzuschleichen, um Potter zu besuchen.«
klauen	(to) snitch	Harry verschwieg den andern, daß er lieber dem sagenhaften Monster Slytherins die Stirn bieten würde als von Snape beim Klauen in seinem Büro erwischt zu werden.
Traube	grape	»Neben ihm lag ein Bündel Trauben«, sagte Professor McGonagall, »wir glauben, er hat versucht sich hier heraufzuschleichen, um Potter zu besuchen.«
geschmolzen	melted	»Geschmolzen«, sagte Madam Pomfrey und schüttelte den Kopf, »alles geschmolzen«– »Was bedeutet das, Albus?«, fragte Professor McGonagall ängstlich.
sächlich	factual	»Ich glaube, ich mach das besser selbst mit dem Klauen«, fuhr Hermine in sachlichem Ton fort.
Eintrag	entry	»Ihr beide werdet rausgeworfen, wenn ihr noch mal was anstellt, und ich habe noch keinen Eintrag.
stiften	donate	Also müßt ihr nur genug Durcheinander stiften, um Snape etwa fünf Minuten lang in Atem zu halten.«
schnippen	flicked	Draco Malfoy, Snapes Lieblingsschüler, schnippte dauernd Pufferfischaugen gegen Ron und Harry, die wußten, wenn sie sich rächen würden, bekämen sie schneller Strafarbeiten aufgehalst, als sie»ungerecht»sagen konnten.
wässrig	aqueous	Er wartete auf Hermines Zeichen und hörte kaum zu, als Snape vor ihn trat und über seine wäßrige Suppe spottete.
hänseln	tease	Als Snape weiterging, um Neville zu hänseln, sah Hermine zu Harry hinüber und nickte.
aufmuntern	encouragingly	»Snape kann nicht beweisen, daß du es warst«, sagte Ron aufmunternd.
soeben	just	Als Harry, Ron und Hermine eine Woche später die Eingangshalle durchquerten, bemerkten sie einen kleinen Menschenauflauf um das schwarze Brett, wo soeben ein Pergament gangepinnt worden war.
Stoßseufzer	sigh	»Solange er nicht «–, begann Harry, doch mit einem Stoßseufzer brach er ab: Gewandet in einen prachtvollen pflaumenblauen Umhang betrat Gilderoy Lockhart die Bühne, und ihm folgte, in seinem üblichen schwarzen Umhang, kein anderer als Snape.
Einzelheit	Details	Nun, Professor Dumbledore hat mir die Erlaubnis erteilt, diesen kleinen Duellierclub zu gründen und euch auszubilden für den Fall, daß ihr euch verteidigen müßt, wie ich selbst es in zahllosen Fällen getan habe – die Einzelheiten lest ihr bitte in meinen Veröffentlichungen nach.
Veröffentlichung	publication	Nun, Professor Dumbledore hat mir die Erlaubnis erteilt, diesen kleinen Duellierclub zu gründen und euch auszubilden für den Fall, daß ihr euch verteidigen müßt, wie ich selbst es in zahllosen Fällen getan habe – die Einzelheiten lest ihr bitte in meinen Veröffentlichungen nach.
anfangs	first	»Er hat mir anvertraut, daß er selbst ein klein wenig vom Duell versteht und sich freundlicherweise bereit erklärt hat, mir anfangs bei einer kleinen Vorführung zu helfen.
unversehrt	intact	Nun, ihr jungen Leute braucht euch keine Sorgen zu machen, wenn ich mit ihm fertig bin, bekommt ihr euren Zaubertranklehrer unversehrt wieder, keine Angst!«
weshalb	why	
Weite	size	Harry fragte sich, weshalb Lockhart eigentlich noch lächelte; wenn Snape ihn so angesehen hätte, hätte er schon längst das Weite gesucht.
rücklings	backward	»Ein blendend scharlachroter Blitz riß Lockhart von den Füßen: rücklings flog er über die Bühne, knallte gegen die Wand, rutschte an ihr herunter und blieb, alle Viere von sich gestreckt, auf dem Boden liegen.
johlen	hooted	Malfoy und einige andere Slytherins johlten.
lehrreich	instructive	»Das war ein Entwaffnungszauber – wie ihr seht, hab ich meinen Zauberstab verloren – ah, danke, Miss Brown – ja, treffliche Idee, ihnen das zu zeigen, Professor Snape, aber verzeihen Sie, wenn ich Ihnen dies sage, es war recht offensichtlich, was Sie vorhatten, und ich hätte es verhindert, wenn ich nur gewollt hätte – allerdings meinte ich, es sei lehrreich, wenn die Schüler es sehen würden«– Snapes Gesicht hatte einen mörderischen Ausdruck angenommen.
auffallen	noticed	Vielleicht war das auch Lockhart aufgefallen, denn er sagte:»Genug der Vorführung!
eitel	Eitel	Eitel grinsend schritt Malfoy herbei.
vierschrötig	burly	Sie war groß und vierschrötig und ihr schwerer Kiefer mahlte angriffslustig.
Schwitzkasten	headlock	Neville und Justin lagen schwer atmend auf dem Boden; Ron half dem aschfahlen Seamus auf die Beine und entschuldigte sich für was immer auch sein lädierter Zauberstab angestellt haben mochte; doch Hermine und Millicent Bulstrode rauften noch miteinander; Millicent hatte Hermine, die vor Schmerz wimmerte, im Schwitzkasten: die Zauberstäbe der beiden lagen vergessen auf dem Boden.
Trümmerfeld	debris field	Er hüpfte durch die Menge und begutachtete das Trümmerfeld.
Verheerung	devastation	»Longbottom richtet mit den einfachsten Zaubersprüchen Verheerungen an, da können wir das, was von Finch-Fletchley übrig bleibt, in einer Streichholzschachtel hoch ins Krankenquartier schicken.
Knall	Pop	Drohend schwang er seinen Zauberstab gegen die Schlange und es gab einen lauten Knall; die Schlange, anstatt zu verschwinden, hob sich vier Meter in die Luft und fiel dann mit einem lauten Klatschen zurück auf den Boden.
Staub	dust	Snape trat vor, wedelte mit seinem Zauberstab und die Schlange löste sich in ein Wölkchen aus schwarzem Staub auf Auch Snape musterte Harry mit einem Blick, den er nicht erwartet hätte: scharf und berechnend, und Harry mochte diesen Blick nicht.
berechnend	calculating	Snape trat vor, wedelte mit seinem Zauberstab und die Schlange löste sich in ein Wölkchen aus schwarzem Staub auf Auch Snape musterte Harry mit einem Blick, den er nicht erwartet hätte: scharf und berechnend, und Harry mochte diesen Blick nicht.
Wolle	wool	Potter muß sich mit Filch in die Wolle gekriegt haben.
Schlamm	sludge	Dieser Erstkläßler Creevey hat Potter beim Quidditch-Spiel geärgert, weil er Bilder von ihm machte, als Potter im Schlamm lag.
Befürchtung	Fears	Offensichtlich hatten sich die schlimmsten Befürchtungen der Hufflepuffs bestätigt.
Pranke	paws	Ein toter Hahn baumelte von einer seiner massigen behandschuhten Pranken herab.
Bannkreis	spell	»Entweder Füchse oder ein Blut saugendes Gespenst, und ich brauch die Erlaubnis des Schulleiters, einen Bannkreis um den Hühnerstall zu ziehen.«
angeln	fishing	»Justin hat auf so etwas gewartet, seit ihm Potter gegenüber herausgerutscht ist, daß er ein Muggelkind ist«– Harry stapfte die Treppen hoch und bog in einen Korridor ein, der noch dunkler war als die anderen; ein scharfer, eisiger Luftzug pfiff durch ein in den Angeln schlagendes Fenster und hatte die Fackeln gelöscht.
stieren	goggling	Justin Finch-Fletchley lag auf dem Boden, steif und kalt und leblos an die Decke stierend, mit einem festgefrorenen Ausdruck des Entsetzens im Gesicht.
reglos	Motionless	Reglos schwebte er eine Handbreit über dem Boden.
Trommelwirbel	drumroll	Harry rappelte sich auf, schnell und flach atmend, und sein Herz vollführte eine Art Trommelwirbel gegen seine Rippen.
Schild	shields	»Was fährt Potter im Schilde?
Purzelbaum	somersault	Er vollendete seinen Purzelbaum und bevor Harry ihn aufhalten konnte, füllte er seine Lungen und brüllte: »ANGRIFF!
gestreift	striped	Professor McGonagall kam herbeigeeilt, gefolgt von ihren Schülern, von denen einer immer noch schwarzweiß gestreiftes Haar hatte.
Anweisung	Instructions	Professor McGonagall beschwor schließlich einen großen Föhn aus dem Nichts herauf und reichte ihn Ernie mit der Anweisung, den Fast Kopflosen Nick die Treppe hochzupusten.
der Föhn	hairdryer	Professor McGonagall beschwor schließlich einen großen Föhn aus dem Nichts herauf und reichte ihn Ernie mit der Anweisung, den Fast Kopflosen Nick die Treppe hochzupusten.
staunen	(to) amaze	Obwohl Harry Angst hatte vor dem, was ihn jetzt erwartete, mußte er einfach staunen.
der Aufzug	elevator	Hinter der Wand war eine Wendeltreppe, die sich langsam nach oben bewegte wie ein Aufzug.
surren	buzzed	Auf den storchbeinigen Tischen standen merkwürdige silberne Instrumente, die surrten und kleine Rauchwolken ausstießen.
ehemalig	former	An den Wänden hingen Bilder ehemaliger Schulleiter und Schulleiterinnen, die alle friedlich in ihren Rahmen dösten.
der Fimmel	craze	Schließlich wisperte ihm eine leise Stimme ins Ohr: »Hast ‘nen kleinen Fimmel, Harry Potter?«
gewitzt	smart	Ähm – tut mir Leid, daß ich dich störe – ich wollte nur fragen «– »Du fragst dich, ob ich dich ins richtige Haus gesteckt habe«, sagte der Hut gewitzt. ja« bei dir war es besonders schwierig.
boshaft	spiteful	Harry starrte ihn an und der Vogel starrte boshaft zurück und ließ erneut sein würgendes Geräusch hören.
sputen	hurry	»Sah seit Tagen schon fürchterlich aus, ich hab ihm gesagt, er solle sich mal sputen.«
die Lasten	expenses	Sie können unglaublich schwere Lasten tragen, ihre Tränen haben heilende Kraft und sie sind außerordentlich treue Haustiere.«
Ansturm	rush	Fast kam es zu einem Ansturm auf die Fahrkarten für den Hogwarts-Express, denn alle wollten über Weihnachten nach Hause.
nachmachen	imitated	Crabbe und Goyle, die Malfoy alles nachmachten, hatten sich ebenfalls in die Liste derer eingetragen, die in den Ferien dableiben wollten.
Vorhut	vanguard	Sie ließen es sich nicht nehmen, als Harrys Vorhut durch die Gänge zu marschieren und zu rufen:»Macht Platz für den Erben von Slytherin, ein gaaanz böser Zauberer kommt hier durch«– Percy mißbilligte dieses Verhalten zutiefst.
zutiefst	deeply	Sie ließen es sich nicht nehmen, als Harrys Vorhut durch die Gänge zu marschieren und zu rufen:»Macht Platz für den Erben von Slytherin, ein gaaanz böser Zauberer kommt hier durch«– Percy mißbilligte dieses Verhalten zutiefst.
ahnungsvoll	foreboding	»Eben weil es fast aus ihm herausplatzt, daß es in Wahrheit er ist«, sagte Ron ahnungsvoll.
Anerkennung	Recognition	»Ihr wißt ja, wie er jeden haßt, der besser ist als er, und du, Harry, kriegst die ganze Anerkennung für seine schmutzige Arbeit.«
Überzeugung	conviction	Percy, der ihr, wie er es nannte, kindisches Betragen verachtete, tauchte selten im Gemeinschaftsraum der Gryffindors auf Er hatte ihnen mit dem Brustton der Überzeugung erklärt, daß er nur deshalb über Weihnachten bleibe, weil es seine Pflicht als Vertrauensschüler sei, die Lehrer in diesen unruhigen Zeiten zu unterstützen.
Zahnstocher	toothpick	Sie hatten Harry einen Zahnstocher geschickt und einen Zettel, auf dem es hieß, er solle fragen, ob er auch während der Sommerferien in Hogwarts bleiben könne.
Eierpunsch	Eggnog	Dumbledore stimmte mit ihnen ein paar seiner liebsten Weihnachtslieder an, wobei Hagrid mit jedem Becher Eierpunsch, den er schluckte, lauter dröhnte.
sachlich	objective	»Wir brauchen immer noch Stückchen von den Leuten, in die ihr euch verwandeln wollt«, sagte Hermine ganz sachlich, als schickte sie die beiden in den Laden, um Waschpulver zu kaufen.
gelassen	left	Ich hab alles genau geplant«, fuhr sie gelassen fort und achtete nicht im Geringsten auf Harrys und Rons verdutzte Gesichter.
reibungslos	smoothly	Doch zu Harrys und Rons kompletter Verblüffung verlief Phase eins ihrer Operation genau so reibungslos, wie Hermine gesagt hatte.
schadenfroh	gleefully	»Wie dick kann man eigentlich werden?«, flüsterte Ron begeistert, als Crabbe schadenfroh auf die Kuchen deutete und sie sich schnappte.
schnappen	(to) snap	»Wie dick kann man eigentlich werden?«, flüsterte Ron begeistert, als Crabbe schadenfroh auf die Kuchen deutete und sie sich schnappte.
Borste	short stiff hair	Sobald sie sicher zwischen den Eimern und Wischern verstaut waren, riss Harry ein paar der Borsten aus, die auf Goyles Stirn wuchsen, und Ron nahm sich ein paar Haare von Crabbe.
der Qualm	fume	Dicker schwarzer Qualm drang aus der Kabine, in der Hermine den Kessel rührte.
die Riegel (pl.)	bars	Mit einem scharrenden Geräusch wurde der Riegel zurückgeschoben und Hermine tauchte vor ihnen auf.
angespannt	tense	Ihr Gesicht glänzte und wirkte angespannt.
träge	lazy	Aus der Nähe sah der Zaubertrank wie dicker, dunkler, träge blubbernder Schlamm aus.
triezen	(to) pester	»Da werden sie dich ganz fürchterlich triezen«, sagte Myrte glücklich.
griesgrämig	grouchy	»Und danken möchte ich den inwischen sechsundvierzig Leuten, die mir Karten geschickt haben. ja, ich habe mir die Freiheit genommen, diese kleine Überraschung für Sie alle vorzubereiten – und es kommt noch besser« Lockhart klatschte in die Hände und durch das Portal zur Eingangshalle marschierte ein Dutzend griesgrämig dreinschauender Zwerge.
die Lupe	magnifying glass	»Keine Ahnung«, sagte Harry, während Ron Harrys Umhang unter die Lupe nahm.
Rührei	scrambled eggs	»Beste Bedingungen für Quidditch!«, sagte Wood begeistert am Gryffindor-Tisch und schaufelte die Teller der Mannschaft mit Rührei voll.
die Traube	a bunch of grapes	Die Hufflepuffs, die in kanariengelb spielten, bildeten eine Traube und besprachen ein letztes Mal ihre Taktik.
meißeln	(to) chisel	Das Bild Hermines wollte ihm einfach nicht aus dem Kopf, wie sie da auf dem Krankenbett lag, als wäre sie aus Stein gemeißelt.
eichen	oak	Als sie das eichene Schloßtor erreichten, fiel ihnen ein Stein vom Herzen.
Nadelstreifenanzug	pinstripe suit	Er trug eine seltsame Mischung von Kleidern: einen Nadelstreifenanzug, eine scharlachrote Krawatte, einen langen schwarzen Umhang und spitze purpurne Stiefel.
missmutig	discontented	»Ich hab niemals«, begann Hagrid und sah Dumbledore flehend an, »Sie wissen, Professor Dumbledore, Sir, ich hab nie «– »Ich möchte klarstellen, Cornelius, daß Hagrid mein volles Vertrauen genießt«, sagte Dumbledore und sah Fudge mißmutig an.
Vernehmen	reportedly	Das Ministerium muß etwas unternehmen – die Schulräte haben sich ins Vernehmen gesetzt «– »Ich sage Ihnen noch mal, Cornelius, wenn Sie Hagrid mitnehmen, wird uns das keinen Schritt weiterbringen«, sagte Dumbledore.
Vorsichtsmaßnahme	Reminder	»Keine Strafe, Hagrid, eher eine Vorsichtsmaßnahme.
verächtlich	contemptuously	»Guter Mann, bitte seien Sie versichert, es ist mir kein Vergnügen, in Ihrem – ähm – Sie nennen es Haus – zu sein«, sagte Lucius Malfoy und sah sich verächtlich in der kleinen Hütte um.
Auffassung	view	»Aber die Schulräte sind der Auffassung, es sei an der Zeit, daß Sie einem andern Platz machen.
Verlust	loss	Wenn es so weitergeht, gibt es bald keine Muggelstämmigen mehr in Hogwarts, und wir alle wissen, welch schlimmer Verlust das für die Schule wäre.«
Ernennung	appointment	»Oh, nun aber immer mit der Ruhe, Lucius«, sagte Fudge nervös, »Dumbledore beurlauben – nein, nein – das ist das Letzte, was wir jetzt wollen «– »Die Ernennung – oder Entlassung – eines Schulleiters ist Aufgabe der Schulräte, Fudge«, sagte Mr Malfoy beiläufig.
Entlassung	release	»Oh, nun aber immer mit der Ruhe, Lucius«, sagte Fudge nervös, »Dumbledore beurlauben – nein, nein – das ist das Letzte, was wir jetzt wollen «– »Die Ernennung – oder Entlassung – eines Schulleiters ist Aufgabe der Schulräte, Fudge«, sagte Mr Malfoy beiläufig.
unverwandt	steadfastly	Dumbledores hellblaue Augen blickten unverwandt in die kalten grauen Augen Malfoys.
die Treue	loyalty	»Allerdings«, sagte Dumbledore, sehr langsam und deutlich sprechend, so daß keinem ein Wort entging, »allerdings werden Sie feststellen, daß ich diese Schule erst dann endgültig verlasse, wenn mir hier keiner mehr die Treue hält.
vernehmbar	vocal	Fudge, an seinem Hut herumfummelnd, wartete darauf, daß Hagrid vorgehen würde, doch Hagrid rührte sich nicht vom Fleck und sagte deutlich vernehmbar: »Wenn jemand etwas herausfinden will, muß er nur den Spinnen folgen.
